date,state,tot_doses,doses,dose1,dose2,tot_ind
16/01/2021,India,48276,48276,48276,0,48276
17/01/2021,India,58604,10328,58604,0,58604
18/01/2021,India,99449,40845,99449,0,99449
19/01/2021,India,195525,96076,195525,0,195525
20/01/2021,India,251280,55755,251280,0,251280
21/01/2021,India,365965,114685,365965,0,365965
22/01/2021,India,549381,183416,549381,0,549381
23/01/2021,India,759008,209627,759008,0,759008
24/01/2021,India,835058,76050,835058,0,835058
25/01/2021,India,1277104,442046,1277104,0,1277104
26/01/2021,India,1293784,16680,1293784,0,1293784
27/01/2021,India,1726490,432706,1726490,0,1726490
28/01/2021,India,2295491,569001,2295491,0,2295491
29/01/2021,India,2814803,519312,2814803,0,2814803
30/01/2021,India,3067736,252933,3067736,0,3067736
31/01/2021,India,3127107,59371,3127107,0,3127107
01/02/2021,India,3350265,223158,3350265,0,3350265
02/02/2021,India,3527971,177706,3527971,0,3527971
03/02/2021,India,3825835,297864,3825835,0,3825835
04/02/2021,India,4314304,488469,4314304,0,4314304
05/02/2021,India,4765924,451620,4765924,0,4765924
06/02/2021,India,5111827,345903,5111827,0,5111827
07/02/2021,India,5168099,56272,5168099,0,5168099
08/02/2021,India,5615499,447400,5615499,0,5615499
09/02/2021,India,6002474,386975,6002474,0,6002474
10/02/2021,India,6462270,459796,6462270,0,6462270
11/02/2021,India,6958553,496283,6958553,0,6958553
12/02/2021,India,7423817,465264,7423817,0,7423817
13/02/2021,India,7708211,284394,7687352,20859,7687352
14/02/2021,India,7732278,24067,7710367,21911,7710367
15/02/2021,India,8253651,521373,8111162,142489,8111162
16/02/2021,India,8577226,323575,8337600,239626,8337600
17/02/2021,India,9023239,446013,8704698,318541,8704698
18/02/2021,India,9338267,315028,8862491,475776,8862491
19/02/2021,India,10241508,903241,9523567,717941,9523567
20/02/2021,India,10619113,377605,9734505,884608,9734505
21/02/2021,India,10651012,31899,9757217,893795,9757217
22/02/2021,India,11243679,592667,10069263,1174416,10069263
23/02/2021,India,11597768,354089,10288293,1309475,10288293
24/02/2021,India,12042958,445190,10517568,1525390,10517568
25/02/2021,India,12819074,776116,10846192,1972882,10846192
26/02/2021,India,13560932,741858,11141375,2419557,11141375
27/02/2021,India,13560983,51,11141426,2419557,11141426
28/02/2021,India,13561208,225,11141651,2419557,11141651
01/03/2021,India,13561208,0,11141651,2419557,11141651
02/03/2021,India,14533954,972746,11886320,2647634,11886320
03/03/2021,India,15383883,849929,12553326,2830557,12553326
04/03/2021,India,16535703,1151820,13393538,3142165,13393538
05/03/2021,India,17871673,1335970,14415912,3455761,14415912
06/03/2021,India,19170828,1299155,15438495,3732333,15438495
07/03/2021,India,19288666,117838,15541529,3747137,15541529
08/03/2021,India,21038500,1749834,16976138,4062362,16976138
09/03/2021,India,18360243,-2678257,14003206,4357037,18360243
10/03/2021,India,19538547,1178304,14872785,4665762,19538547
11/03/2021,India,19953987,415440,15204375,4749612,19953987
12/03/2021,India,21772159,1818172,16612019,5160140,21772159
13/03/2021,India,23159604,1387445,17698742,5460862,23159604
14/03/2021,India,23317750,158146,17837716,5480034,23317750
15/03/2021,India,25618250,2300500,19766466,5851784,25618250
16/03/2021,India,31870745,6252495,25709257,6161488,25709257
17/03/2021,India,36496020,4625275,30011328,6484692,30011328
18/03/2021,India,38770404,2274384,31952935,6817469,31952935
19/03/2021,India,41309219,2538815,34228371,7080848,34228371
20/03/2021,India,43877868,2568649,36568988,7308880,36568988
21/03/2021,India,44645372,767504,37303458,7341914,37303458
22/03/2021,India,47204633,2559261,39612614,7592019,39612614
23/03/2021,India,49973152,2768519,42148875,7824277,42148875
24/03/2021,India,52216237,2243085,44250191,7966046,44250191
25/03/2021,India,54589220,2372983,46454700,8134520,46454700
26/03/2021,India,57021164,2431944,48749313,8271851,48749313
27/03/2021,India,59235436,2214272,50865316,8370120,50865316
28/03/2021,India,59557120,321684,51179587,8377533,51179587
29/03/2021,India,60183064,625944,51774289,8408775,51774289
30/03/2021,India,61990242,1807178,53429356,8560886,53429356
31/03/2021,India,63935590,1945348,55188803,8746787,55188803
01/04/2021,India,66361722,2426132,57443466,8918256,57443466
02/04/2021,India,70090836,3729114,60936753,9154083,60936753
03/04/2021,India,73112119,3021283,63743700,9368419,63743700
04/04/2021,India,76405697,3293578,66838504,9567193,66838504
05/04/2021,India,79439889,3034192,69620234,9819655,69620234
06/04/2021,India,82065337,2625448,72035640,10029697,72035640
07/04/2021,India,87100627,5035290,76671812,10428815,76671812
08/04/2021,India,91881530,4780903,80998099,10883431,80998099
09/04/2021,India,95583419,3701889,84296847,11286572,84296847
10/04/2021,India,99069354,3485935,87411872,11657482,87411872
11/04/2021,India,102000401,2931047,90111528,11888873,90111528
12/04/2021,India,105970539,3970138,93559587,12410952,93559587
13/04/2021,India,108598289,2627750,95823614,12774675,95823614
14/04/2021,India,111913288,3314999,98703696,13209592,98703696
15/04/2021,India,114598026,2684738,100853671,13744355,100853671
16/04/2021,India,117305344,2707318,102927296,14378048,102927296
17/04/2021,India,119971369,2666025,104950409,15020960,104950409
18/04/2021,India,121207098,1235729,105896430,15310668,105896430
19/04/2021,India,124457162,3250064,108178574,16278588,108178574
20/04/2021,India,127428887,2971725,110165234,17263653,110165234
21/04/2021,India,129646105,2217218,111673361,17972744,111673361
22/04/2021,India,132754608,3108503,113584269,19170339,113584269
23/04/2021,India,135658324,2903716,115461202,20197122,115461202
24/04/2021,India,138185956,2527632,117105343,21080613,117105343
25/04/2021,India,139185173,999217,117795008,21390165,117795008
26/04/2021,India,142524947,3339774,119886252,22638695,119886252
27/04/2021,India,144879233,2354286,121263287,23615946,121263287
28/04/2021,India,147053392,2174159,122538179,24515213,122538179
29/04/2021,India,149268772,2215380,123811908,25456864,123811908
30/04/2021,India,151998107,2729335,125376952,26621155,125376952
01/05/2021,India,153626325,1628218,126328970,27297355,126328970
02/05/2021,India,154211511,585186,126704151,27507360,126704151
03/05/2021,India,156082136,1870625,127696675,28385461,127696675
04/05/2021,India,157750752,1668616,128627919,29122833,128627919
05/05/2021,India,159931238,2180486,129730641,30200597,129730641
06/05/2021,India,162603603,2672365,131058890,31544713,131058890
07/05/2021,India,165190000,2586397,132294827,32895173,132294827
08/05/2021,India,167493857,2303857,133366482,34127375,133366482
09/05/2021,India,168304868,811011,133854676,34450192,133854676
10/05/2021,India,171098918,2794050,135192013,35906905,135192013
11/05/2021,India,173862643,2763725,136557345,37305298,136557345
12/05/2021,India,176045577,2182934,137805245,38240332,137805245
13/05/2021,India,178361846,2316269,139087590,39274256,139087590
14/05/2021,India,179646413,1284567,139861462,39784951,139861462
15/05/2021,India,181544536,1898123,141132112,40412424,141132112
16/05/2021,India,182251006,706470,141764335,40486671,141764335
17/05/2021,India,183817204,1566198,143090218,40726986,143090218
18/05/2021,India,185191602,1374398,144270200,40921402,144270200
19/05/2021,India,186410600,1218998,145333606,41076994,145333606
20/05/2021,India,187886885,1476285,146624652,41262233,146624652
21/05/2021,India,189344105,1457220,147893976,41450129,147893976
22/05/2021,India,190936859,1592754,149302864,41633995,149302864
23/05/2021,India,191877460,940601,150180408,41697052,150180408
24/05/2021,India,194313920,2436460,152439044,41874876,152439044
25/05/2021,India,196463495,2149575,154384464,42079031,154384464
26/05/2021,India,198425615,1962120,156189641,42235974,156189641
27/05/2021,India,201438120,3012505,159006359,42431761,159006359
28/05/2021,India,204617572,3179452,161951713,42665859,161951713
29/05/2021,India,207796464,3178892,164804095,42992369,164804095
30/05/2021,India,208907723,1111259,165823004,43084719,165823004
31/05/2021,India,211778491,2870768,168393525,43384966,168393525
01/06/2021,India,214314522,2536031,170640412,43674110,170640412
02/06/2021,India,216858197,2543675,172945950,43912247,172945950
03/06/2021,India,219831571,2973374,175677634,44153937,175677634
04/06/2021,India,223642281,3810710,179205337,44436944,179205337
05/06/2021,India,227162503,3520222,182451348,44711155,182451348
06/06/2021,India,228624578,1462075,183824958,44799620,183824958
07/06/2021,India,232063488,3438910,186933771,45129717,186933771
08/06/2021,India,234952618,2889130,189503126,45449492,189503126
09/06/2021,India,238440129,3487511,192669299,45770830,192669299
10/06/2021,India,241846863,3406734,195747476,46099387,195747476
11/06/2021,India,245411955,3565092,198977594,46434361,198977594
12/06/2021,India,249033094,3621139,202207183,46825911,202207183
13/06/2021,India,250656362,1623268,203705131,46951231,203705131
14/06/2021,India,254653040,3996678,207274441,47378599,207274441
15/06/2021,India,257605528,2952488,209816439,47789089,209816439
16/06/2021,India,261118468,3512940,212945352,48173116,212945352
17/06/2021,India,264537245,3418777,215944608,48592637,215944608
18/06/2021,India,267951571,3414326,218956863,48994708,218956863
19/06/2021,India,271833642,3882071,222316897,49516745,222316897
20/06/2021,India,275018693,3185051,225211708,49806985,225211708
21/06/2021,India,283891764,8873071,233288807,50602957,233288807
22/06/2021,India,289961746,6069982,238685516,51276230,238685516
23/06/2021,India,296892521,6930775,244944880,51947641,244944880
24/06/2021,India,303426850,6534329,250656880,52769970,250656880
25/06/2021,India,309802519,6375669,256135000,53667519,
26/06/2021,India,316535775,6733256,261705883,54829892,
27/06/2021,India,318473492,1937717,263289938,55183554,
28/06/2021,India,323836329,5362837,267485789,56350540,
29/06/2021,India,327685422,3849093,270392224,57293198,
30/06/2021,India,330553623,2868201,272487181,58066442,
01/07/2021,India,334913220,4359597,275842378,59070842,
02/07/2021,India,339447068,4533848,279132514,60314554,
03/07/2021,India,346054022,6606954,283527017,62527005,
04/07/2021,India,347766247,1712225,284750483,63015764,
05/07/2021,India,352412289,4646042,287588808,64823481,
06/07/2021,India,356192949,3780660,290132865,66060084,
07/07/2021,India,359728245,3535296,292326546,67401699,
08/07/2021,India,363866177,4137932,295113298,68752879,
09/07/2021,India,367079052,3212875,297184419,69894633,
10/07/2021,India,370921397,3842345,299620148,71301249,
11/07/2021,India,372249777,1328380,300474970,71774807,
12/07/2021,India,376350562,4100785,303057816,73292746,
13/07/2021,India,380212639,3862077,305477371,74735268,
14/07/2021,India,386288141,6075502,310042014,76246127,
15/07/2021,India,390286930,3998789,312624872,77662058,
16/07/2021,India,394641704,4354774,315177274,79464430,
17/07/2021,India,399873648,5231944,318403675,81469973,
18/07/2021,India,401441969,1568321,319469878,81972091,
19/07/2021,India,406790133,5348164,322905680,83884453,
20/07/2021,India,410430826,3640693,325242678,85188148,
21/07/2021,India,412817034,2386208,326792911,86024123,
22/07/2021,India,418366838,5549804,330465663,87901175,
23/07/2021,India,422845298,4478460,333352959,89492339,
24/07/2021,India,428109930,5264632,336917806,91192124,
25/07/2021,India,430170531,2060601,338346937,91823594,
26/07/2021,India,436861480,6690949,343039824,93821656,
27/07/2021,India,441128674,4267194,345867755,95260919,
28/07/2021,India,445696580,4567906,349104325,96592255,
29/07/2021,India,450997892,5301312,352679959,98317933,
30/07/2021,India,456471250,5473358,356348903,100122347,
31/07/2021,India,463113439,6642189,361264651,101848788,
01/08/2021,India,467769865,4656426,365110984,102658881,
02/08/2021,India,473977156,6207291,369654820,104322336,
03/08/2021,India,480643928,6666772,375040194,105603734,
04/08/2021,India,484911273,4267345,378269912,106641361,
05/08/2021,India,490760938,5849665,382658786,108102152,
06/08/2021,India,500087070,9326132,390344882,109742188,
07/08/2021,India,505787038,5699968,394599261,111187777,
08/08/2021,India,507727903,1940865,395961470,111766433,
09/08/2021,India,513228400,5500497,400150406,113077994,
,,,,,,
,,,,,,
,,,,,,
,,,,,,
,,,,,,
,,,,,,
16/01/2021,Andaman and Nicobar Islands,23,23,23,0,23
17/01/2021,Andaman and Nicobar Islands,23,0,23,0,23
18/01/2021,Andaman and Nicobar Islands,42,19,42,0,42
19/01/2021,Andaman and Nicobar Islands,89,47,89,0,89
20/01/2021,Andaman and Nicobar Islands,124,35,124,0,124
21/01/2021,Andaman and Nicobar Islands,239,115,239,0,239
22/01/2021,Andaman and Nicobar Islands,552,313,552,0,552
23/01/2021,Andaman and Nicobar Islands,920,368,920,0,920
24/01/2021,Andaman and Nicobar Islands,966,46,966,0,966
25/01/2021,Andaman and Nicobar Islands,1519,553,1519,0,1519
26/01/2021,Andaman and Nicobar Islands,1519,0,1519,0,1519
27/01/2021,Andaman and Nicobar Islands,1519,0,1519,0,1519
28/01/2021,Andaman and Nicobar Islands,1956,437,1956,0,1956
29/01/2021,Andaman and Nicobar Islands,2024,68,2024,0,2024
30/01/2021,Andaman and Nicobar Islands,2060,36,2060,0,2060
31/01/2021,Andaman and Nicobar Islands,2060,0,2060,0,2060
01/02/2021,Andaman and Nicobar Islands,2060,0,2060,0,2060
02/02/2021,Andaman and Nicobar Islands,2060,0,2060,0,2060
03/02/2021,Andaman and Nicobar Islands,2107,47,2107,0,2107
04/02/2021,Andaman and Nicobar Islands,2290,183,2290,0,2290
05/02/2021,Andaman and Nicobar Islands,2514,224,2514,0,2514
06/02/2021,Andaman and Nicobar Islands,2780,266,2780,0,2780
07/02/2021,Andaman and Nicobar Islands,2780,0,2780,0,2780
08/02/2021,Andaman and Nicobar Islands,2780,0,2780,0,2780
09/02/2021,Andaman and Nicobar Islands,2780,0,2780,0,2780
10/02/2021,Andaman and Nicobar Islands,2780,0,2780,0,2780
11/02/2021,Andaman and Nicobar Islands,2780,0,2780,0,2780
12/02/2021,Andaman and Nicobar Islands,2852,72,2852,0,2852
13/02/2021,Andaman and Nicobar Islands,3040,188,3040,0,3040
14/02/2021,Andaman and Nicobar Islands,3040,0,3040,0,3040
15/02/2021,Andaman and Nicobar Islands,3467,427,3363,104,3363
16/02/2021,Andaman and Nicobar Islands,3467,0,3363,104,3363
17/02/2021,Andaman and Nicobar Islands,3664,197,3560,104,3560
18/02/2021,Andaman and Nicobar Islands,3846,182,3505,341,3505
19/02/2021,Andaman and Nicobar Islands,4898,1052,4246,652,4246
20/02/2021,Andaman and Nicobar Islands,5653,755,4707,946,4707
21/02/2021,Andaman and Nicobar Islands,5653,0,4707,946,4707
22/02/2021,Andaman and Nicobar Islands,6856,1203,5358,1498,5358
23/02/2021,Andaman and Nicobar Islands,7058,202,5436,1622,5436
24/02/2021,Andaman and Nicobar Islands,7240,182,5518,1722,5518
25/02/2021,Andaman and Nicobar Islands,7763,523,5867,1896,5867
26/02/2021,Andaman and Nicobar Islands,7989,226,6029,1960,6029
27/02/2021,Andaman and Nicobar Islands,7989,0,6029,1960,6029
28/02/2021,Andaman and Nicobar Islands,7989,0,6029,1960,6029
01/03/2021,Andaman and Nicobar Islands,7989,0,6029,1960,6029
02/03/2021,Andaman and Nicobar Islands,8724,735,6638,2086,6638
03/03/2021,Andaman and Nicobar Islands,8837,113,6749,2088,6749
04/03/2021,Andaman and Nicobar Islands,9361,524,7266,2095,7266
05/03/2021,Andaman and Nicobar Islands,9897,536,7799,2098,7799
06/03/2021,Andaman and Nicobar Islands,10498,601,8288,2210,8288
07/03/2021,Andaman and Nicobar Islands,11101,603,8848,2253,8848
08/03/2021,Andaman and Nicobar Islands,12004,903,9629,2375,9629
09/03/2021,Andaman and Nicobar Islands,9932,-2072,7542,2390,9932
10/03/2021,Andaman and Nicobar Islands,10161,229,7735,2426,10161
11/03/2021,Andaman and Nicobar Islands,10704,543,8218,2486,10704
12/03/2021,Andaman and Nicobar Islands,11321,617,8735,2586,11321
13/03/2021,Andaman and Nicobar Islands,11638,317,8899,2739,11638
14/03/2021,Andaman and Nicobar Islands,11693,55,8926,2767,11693
15/03/2021,Andaman and Nicobar Islands,12045,352,9202,2843,12045
16/03/2021,Andaman and Nicobar Islands,14826,2781,11950,2876,11950
17/03/2021,Andaman and Nicobar Islands,15489,663,12509,2980,12509
18/03/2021,Andaman and Nicobar Islands,16131,642,12948,3183,12948
19/03/2021,Andaman and Nicobar Islands,16612,481,13293,3319,13293
20/03/2021,Andaman and Nicobar Islands,17451,839,13852,3599,13852
21/03/2021,Andaman and Nicobar Islands,17478,27,13868,3610,13868
22/03/2021,Andaman and Nicobar Islands,18085,607,14327,3758,14327
23/03/2021,Andaman and Nicobar Islands,19121,1036,15017,4104,15017
24/03/2021,Andaman and Nicobar Islands,19693,572,15247,4446,15247
25/03/2021,Andaman and Nicobar Islands,20318,625,15652,4666,15652
26/03/2021,Andaman and Nicobar Islands,20789,471,15933,4856,15933
27/03/2021,Andaman and Nicobar Islands,21356,567,16292,5064,16292
28/03/2021,Andaman and Nicobar Islands,21358,2,16293,5065,16293
29/03/2021,Andaman and Nicobar Islands,21357,-1,16292,5065,16292
30/03/2021,Andaman and Nicobar Islands,21840,483,16701,5139,16701
31/03/2021,Andaman and Nicobar Islands,21938,98,16798,5140,16798
01/04/2021,Andaman and Nicobar Islands,22608,670,17435,5173,17435
02/04/2021,Andaman and Nicobar Islands,22738,130,17559,5179,17559
03/04/2021,Andaman and Nicobar Islands,23221,483,17998,5223,17998
04/04/2021,Andaman and Nicobar Islands,23901,680,18677,5224,18677
05/04/2021,Andaman and Nicobar Islands,24774,873,19499,5275,19499
06/04/2021,Andaman and Nicobar Islands,25766,992,20445,5321,20445
07/04/2021,Andaman and Nicobar Islands,27978,2212,22631,5347,22631
08/04/2021,Andaman and Nicobar Islands,30766,2788,25363,5403,25363
09/04/2021,Andaman and Nicobar Islands,33217,2451,27698,5519,27698
10/04/2021,Andaman and Nicobar Islands,35433,2216,29863,5570,29863
11/04/2021,Andaman and Nicobar Islands,37624,2191,32012,5612,32012
12/04/2021,Andaman and Nicobar Islands,42285,4661,36572,5713,36572
13/04/2021,Andaman and Nicobar Islands,48845,6560,43013,5832,43013
14/04/2021,Andaman and Nicobar Islands,55595,6750,49654,5941,49654
15/04/2021,Andaman and Nicobar Islands,60857,5262,54778,6079,54778
16/04/2021,Andaman and Nicobar Islands,67662,6805,61339,6323,61339
17/04/2021,Andaman and Nicobar Islands,74019,6357,67451,6568,67451
18/04/2021,Andaman and Nicobar Islands,78153,4134,71275,6878,71275
19/04/2021,Andaman and Nicobar Islands,83028,4875,75675,7353,75675
20/04/2021,Andaman and Nicobar Islands,86910,3882,78973,7937,78973
21/04/2021,Andaman and Nicobar Islands,89072,2162,80901,8171,80901
22/04/2021,Andaman and Nicobar Islands,91833,2761,83233,8600,83233
23/04/2021,Andaman and Nicobar Islands,94166,2333,85201,8965,85201
24/04/2021,Andaman and Nicobar Islands,96093,1927,86796,9297,86796
25/04/2021,Andaman and Nicobar Islands,97392,1299,87865,9527,87865
26/04/2021,Andaman and Nicobar Islands,99109,1717,89290,9819,89290
27/04/2021,Andaman and Nicobar Islands,100571,1462,90454,10117,90454
28/04/2021,Andaman and Nicobar Islands,101770,1199,91394,10376,91394
29/04/2021,Andaman and Nicobar Islands,102998,1228,92417,10581,92417
30/04/2021,Andaman and Nicobar Islands,104374,1376,93493,10881,93493
01/05/2021,Andaman and Nicobar Islands,105090,716,94002,11088,94002
02/05/2021,Andaman and Nicobar Islands,105285,195,94125,11160,94125
03/05/2021,Andaman and Nicobar Islands,106250,965,94633,11617,94633
04/05/2021,Andaman and Nicobar Islands,107018,768,95064,11954,95064
05/05/2021,Andaman and Nicobar Islands,107955,937,95500,12455,95500
06/05/2021,Andaman and Nicobar Islands,109060,1105,96229,12831,96229
07/05/2021,Andaman and Nicobar Islands,110161,1101,96970,13191,96970
08/05/2021,Andaman and Nicobar Islands,111168,1007,97639,13529,97639
09/05/2021,Andaman and Nicobar Islands,111285,117,97748,13537,97748
10/05/2021,Andaman and Nicobar Islands,112403,1118,98439,13964,98439
11/05/2021,Andaman and Nicobar Islands,113019,616,98845,14174,98845
12/05/2021,Andaman and Nicobar Islands,113622,603,99218,14404,99218
13/05/2021,Andaman and Nicobar Islands,114400,778,99602,14798,99602
14/05/2021,Andaman and Nicobar Islands,114498,98,99690,14808,99690
15/05/2021,Andaman and Nicobar Islands,115188,690,100058,15130,100058
16/05/2021,Andaman and Nicobar Islands,115188,0,100058,15130,100058
17/05/2021,Andaman and Nicobar Islands,115627,439,100492,15135,100492
18/05/2021,Andaman and Nicobar Islands,115911,284,100773,15138,100773
19/05/2021,Andaman and Nicobar Islands,116427,516,101277,15150,101277
20/05/2021,Andaman and Nicobar Islands,117180,753,102027,15153,102027
21/05/2021,Andaman and Nicobar Islands,117950,770,102795,15155,102795
22/05/2021,Andaman and Nicobar Islands,118761,811,103605,15156,103605
23/05/2021,Andaman and Nicobar Islands,119144,383,103988,15156,103988
24/05/2021,Andaman and Nicobar Islands,119595,451,104439,15156,104439
25/05/2021,Andaman and Nicobar Islands,120282,687,105124,15158,105124
26/05/2021,Andaman and Nicobar Islands,121091,809,105933,15158,105933
27/05/2021,Andaman and Nicobar Islands,121709,618,106548,15161,106548
28/05/2021,Andaman and Nicobar Islands,122466,757,107304,15162,107304
29/05/2021,Andaman and Nicobar Islands,123483,1017,108317,15166,108317
30/05/2021,Andaman and Nicobar Islands,123725,242,108559,15166,108559
31/05/2021,Andaman and Nicobar Islands,124268,543,109087,15181,109087
01/06/2021,Andaman and Nicobar Islands,125007,739,109821,15186,109821
02/06/2021,Andaman and Nicobar Islands,125514,507,110323,15191,110323
03/06/2021,Andaman and Nicobar Islands,126200,686,111001,15199,111001
04/06/2021,Andaman and Nicobar Islands,126713,513,111506,15207,111506
05/06/2021,Andaman and Nicobar Islands,127194,481,111971,15223,111971
06/06/2021,Andaman and Nicobar Islands,127202,8,111979,15223,111979
07/06/2021,Andaman and Nicobar Islands,127759,557,112507,15252,112507
08/06/2021,Andaman and Nicobar Islands,128195,436,112917,15278,112917
09/06/2021,Andaman and Nicobar Islands,128498,303,113207,15291,113207
10/06/2021,Andaman and Nicobar Islands,129402,904,114098,15304,114098
11/06/2021,Andaman and Nicobar Islands,130173,771,114850,15323,114850
12/06/2021,Andaman and Nicobar Islands,131060,887,115708,15352,115708
13/06/2021,Andaman and Nicobar Islands,131063,3,115711,15352,115711
14/06/2021,Andaman and Nicobar Islands,132004,941,116632,15372,116632
15/06/2021,Andaman and Nicobar Islands,132939,935,117545,15394,117545
16/06/2021,Andaman and Nicobar Islands,133931,992,118511,15420,118511
17/06/2021,Andaman and Nicobar Islands,134897,966,119448,15449,119448
18/06/2021,Andaman and Nicobar Islands,135850,953,120382,15468,120382
19/06/2021,Andaman and Nicobar Islands,136707,857,121201,15506,121201
20/06/2021,Andaman and Nicobar Islands,136708,1,121202,15506,121202
21/06/2021,Andaman and Nicobar Islands,137495,787,121964,15531,121964
22/06/2021,Andaman and Nicobar Islands,140296,2801,124729,15567,124729
23/06/2021,Andaman and Nicobar Islands,144234,3938,128630,15604,128630
24/06/2021,Andaman and Nicobar Islands,149318,5084,133533,15785,133533
25/06/2021,Andaman and Nicobar Islands,154100,4782,138254,15846,
26/06/2021,Andaman and Nicobar Islands,159630,5530,143329,16301,
27/06/2021,Andaman and Nicobar Islands,161325,1695,145019,16306,
28/06/2021,Andaman and Nicobar Islands,165921,4596,148486,17435,
29/06/2021,Andaman and Nicobar Islands,171590,5669,153048,18542,
30/06/2021,Andaman and Nicobar Islands,176293,4703,156470,19823,
01/07/2021,Andaman and Nicobar Islands,178502,2209,157304,21198,
02/07/2021,Andaman and Nicobar Islands,181221,2719,158335,22886,
03/07/2021,Andaman and Nicobar Islands,184103,2882,159330,24773,
04/07/2021,Andaman and Nicobar Islands,184515,412,159342,25173,
05/07/2021,Andaman and Nicobar Islands,189428,4913,160292,29136,
06/07/2021,Andaman and Nicobar Islands,196475,7047,161400,35075,
07/07/2021,Andaman and Nicobar Islands,202865,6390,162373,40492,
08/07/2021,Andaman and Nicobar Islands,208594,5729,163284,45310,
09/07/2021,Andaman and Nicobar Islands,215725,7131,164079,51646,
10/07/2021,Andaman and Nicobar Islands,222583,6858,166096,56487,
11/07/2021,Andaman and Nicobar Islands,223059,476,166343,56716,
12/07/2021,Andaman and Nicobar Islands,230450,7391,168328,62122,
13/07/2021,Andaman and Nicobar Islands,236645,6195,170392,66253,
14/07/2021,Andaman and Nicobar Islands,246669,10024,177013,69656,
15/07/2021,Andaman and Nicobar Islands,251147,4478,178771,72376,
16/07/2021,Andaman and Nicobar Islands,254814,3667,179879,74935,
17/07/2021,Andaman and Nicobar Islands,257871,3057,180673,77198,
18/07/2021,Andaman and Nicobar Islands,258110,239,180805,77305,
19/07/2021,Andaman and Nicobar Islands,261259,3149,181725,79534,
20/07/2021,Andaman and Nicobar Islands,265699,4440,184157,81542,
21/07/2021,Andaman and Nicobar Islands,265754,55,184160,81594,
22/07/2021,Andaman and Nicobar Islands,270664,4910,187006,83658,
23/07/2021,Andaman and Nicobar Islands,275377,4713,190151,85226,
24/07/2021,Andaman and Nicobar Islands,279195,3818,192718,86477,
25/07/2021,Andaman and Nicobar Islands,279839,644,193281,86558,
26/07/2021,Andaman and Nicobar Islands,282966,3127,195082,87884,
27/07/2021,Andaman and Nicobar Islands,286856,3890,197991,88865,
28/07/2021,Andaman and Nicobar Islands,290801,3945,201244,89557,
29/07/2021,Andaman and Nicobar Islands,294198,3397,203975,90223,
30/07/2021,Andaman and Nicobar Islands,296896,2698,206031,90865,
31/07/2021,Andaman and Nicobar Islands,298969,2073,207419,91550,
01/08/2021,Andaman and Nicobar Islands,301367,2398,209737,91630,
02/08/2021,Andaman and Nicobar Islands,302726,1359,210578,92148,
03/08/2021,Andaman and Nicobar Islands,304142,1416,211561,92581,
04/08/2021,Andaman and Nicobar Islands,305729,1587,212571,93158,
05/08/2021,Andaman and Nicobar Islands,307014,1285,213457,93557,
06/08/2021,Andaman and Nicobar Islands,308177,1163,214333,93844,
07/08/2021,Andaman and Nicobar Islands,309270,1093,215021,94249,
08/08/2021,Andaman and Nicobar Islands,309349,79,215077,94272,
09/08/2021,Andaman and Nicobar Islands,310643,1294,216046,94597,
,,,,,,
,,,,,,
,,,,,,
,,,,,,
,,,,,,
,,,,,,
16/01/2021,Andhra Pradesh,4216,4216,4216,0,4216
17/01/2021,Andhra Pradesh,9251,5035,9251,0,9251
18/01/2021,Andhra Pradesh,12234,2983,12234,0,12234
19/01/2021,Andhra Pradesh,25539,13305,25539,0,25539
20/01/2021,Andhra Pradesh,35901,10362,35901,0,35901
21/01/2021,Andhra Pradesh,45040,9139,45040,0,45040
22/01/2021,Andhra Pradesh,55697,10657,55697,0,55697
23/01/2021,Andhra Pradesh,70380,14683,70380,0,70380
24/01/2021,Andhra Pradesh,74221,3841,74221,0,74221
25/01/2021,Andhra Pradesh,89879,15658,89879,0,89879
26/01/2021,Andhra Pradesh,90616,737,90616,0,90616
27/01/2021,Andhra Pradesh,107999,17383,107999,0,107999
28/01/2021,Andhra Pradesh,117543,9544,117543,0,117543
29/01/2021,Andhra Pradesh,124647,7104,124647,0,124647
30/01/2021,Andhra Pradesh,133571,8924,133571,0,133571
31/01/2021,Andhra Pradesh,133623,52,133623,0,133623
01/02/2021,Andhra Pradesh,133642,19,133642,0,133642
02/02/2021,Andhra Pradesh,133646,4,133646,0,133646
03/02/2021,Andhra Pradesh,161302,27656,161302,0,161302
04/02/2021,Andhra Pradesh,188704,27402,188704,0,188704
05/02/2021,Andhra Pradesh,218899,30195,218899,0,218899
06/02/2021,Andhra Pradesh,245938,27039,245938,0,245938
07/02/2021,Andhra Pradesh,249205,3267,249205,0,249205
08/02/2021,Andhra Pradesh,263588,14383,263588,0,263588
09/02/2021,Andhra Pradesh,275654,12066,275654,0,275654
10/02/2021,Andhra Pradesh,286401,10747,286401,0,286401
11/02/2021,Andhra Pradesh,294574,8173,294574,0,294574
12/02/2021,Andhra Pradesh,303031,8457,303031,0,303031
13/02/2021,Andhra Pradesh,319740,16709,313507,6233,313507
14/02/2021,Andhra Pradesh,319743,3,313509,6234,313509
15/02/2021,Andhra Pradesh,345830,26087,329041,16789,329041
16/02/2021,Andhra Pradesh,370880,25050,344146,26734,344146
17/02/2021,Andhra Pradesh,402851,31971,364844,38007,364844
18/02/2021,Andhra Pradesh,414038,11187,359785,54253,359785
19/02/2021,Andhra Pradesh,476505,62467,403279,73226,403279
20/02/2021,Andhra Pradesh,501288,24783,413818,87470,413818
21/02/2021,Andhra Pradesh,509044,7756,418634,90410,418634
22/02/2021,Andhra Pradesh,534507,25463,431789,102718,431789
23/02/2021,Andhra Pradesh,559483,24976,448490,110993,448490
24/02/2021,Andhra Pradesh,596327,36844,476866,119461,476866
25/02/2021,Andhra Pradesh,639187,42860,510185,129002,510185
26/02/2021,Andhra Pradesh,673767,34580,535955,137812,535955
27/02/2021,Andhra Pradesh,673767,0,535955,137812,535955
28/02/2021,Andhra Pradesh,673767,0,535955,137812,535955
01/03/2021,Andhra Pradesh,673767,0,535955,137812,535955
02/03/2021,Andhra Pradesh,702035,28268,559569,142466,559569
03/03/2021,Andhra Pradesh,724119,22084,577662,146457,577662
04/03/2021,Andhra Pradesh,749445,25326,596324,153121,596324
05/03/2021,Andhra Pradesh,785259,35814,620332,164927,620332
06/03/2021,Andhra Pradesh,836177,50918,653058,183119,653058
07/03/2021,Andhra Pradesh,836337,160,653146,183191,653146
08/03/2021,Andhra Pradesh,886175,49838,688936,197239,688936
09/03/2021,Andhra Pradesh,740389,-145786,530098,210291,740389
10/03/2021,Andhra Pradesh,781210,40821,561939,219271,781210
11/03/2021,Andhra Pradesh,789453,8243,568693,220760,789453
12/03/2021,Andhra Pradesh,837831,48378,606440,231391,837831
13/03/2021,Andhra Pradesh,881112,43281,643857,237255,881112
14/03/2021,Andhra Pradesh,881921,809,644610,237311,881921
15/03/2021,Andhra Pradesh,955901,73980,708969,246932,955901
16/03/2021,Andhra Pradesh,1234075,278174,976078,257997,976078
17/03/2021,Andhra Pradesh,1380960,146885,1112607,268353,1112607
18/03/2021,Andhra Pradesh,1472043,91083,1194255,277788,1194255
19/03/2021,Andhra Pradesh,1569131,97088,1280956,288175,1280956
20/03/2021,Andhra Pradesh,1681001,111870,1381802,299199,1381802
21/03/2021,Andhra Pradesh,1689691,8690,1389085,300606,1389085
22/03/2021,Andhra Pradesh,1803338,113647,1494286,309052,1494286
23/03/2021,Andhra Pradesh,1939162,135824,1617797,321365,1617797
24/03/2021,Andhra Pradesh,2062333,123171,1729748,332585,1729748
25/03/2021,Andhra Pradesh,2211652,149319,1864559,347093,1864559
26/03/2021,Andhra Pradesh,2320613,108961,1960827,359786,1960827
27/03/2021,Andhra Pradesh,2451110,130497,2078246,372864,2078246
28/03/2021,Andhra Pradesh,2461015,9905,2086565,374450,2086565
29/03/2021,Andhra Pradesh,2527121,66106,2149525,377596,2149525
30/03/2021,Andhra Pradesh,2621769,94648,2234331,387438,2234331
31/03/2021,Andhra Pradesh,2725169,103400,2328018,397151,2328018
01/04/2021,Andhra Pradesh,2825721,100552,2421043,404678,2421043
02/04/2021,Andhra Pradesh,2898547,72826,2487480,411067,2487480
03/04/2021,Andhra Pradesh,2986837,88290,2566814,420023,2566814
04/04/2021,Andhra Pradesh,3047568,60731,2621707,425861,2621707
05/04/2021,Andhra Pradesh,3142814,95246,2706804,436010,2706804
06/04/2021,Andhra Pradesh,3207917,65103,2764322,443595,2764322
07/04/2021,Andhra Pradesh,3352010,144093,2890332,461678,2890332
08/04/2021,Andhra Pradesh,3496367,144357,3020007,476360,3020007
09/04/2021,Andhra Pradesh,3571106,74739,3081066,490040,3081066
10/04/2021,Andhra Pradesh,3803237,232131,3281351,521886,3281351
11/04/2021,Andhra Pradesh,3892459,89222,3362926,529533,3362926
12/04/2021,Andhra Pradesh,3913669,21210,3380423,533246,3380423
13/04/2021,Andhra Pradesh,3918519,4850,3383754,534765,3383754
14/04/2021,Andhra Pradesh,4558756,640237,3973533,585223,3973533
15/04/2021,Andhra Pradesh,4597442,38686,4003901,593541,4003901
16/04/2021,Andhra Pradesh,4603722,6280,4007469,596253,4007469
17/04/2021,Andhra Pradesh,4607860,4138,4009940,597920,4009940
18/04/2021,Andhra Pradesh,4613016,5156,4013140,599876,4013140
19/04/2021,Andhra Pradesh,4756582,143566,4140526,616056,4140526
20/04/2021,Andhra Pradesh,4927355,170773,4234572,692783,4234572
21/04/2021,Andhra Pradesh,4968449,41094,4257182,711267,4257182
22/04/2021,Andhra Pradesh,5327886,359437,4337021,990865,4337021
23/04/2021,Andhra Pradesh,5554779,226893,4464620,1090159,4464620
24/04/2021,Andhra Pradesh,5669867,115088,4543318,1126549,4543318
25/04/2021,Andhra Pradesh,5678642,8775,4547972,1130670,4547972
26/04/2021,Andhra Pradesh,5986083,307441,4761686,1224397,4761686
27/04/2021,Andhra Pradesh,6177693,191610,4904030,1273663,4904030
28/04/2021,Andhra Pradesh,6281949,104256,4955046,1326903,4955046
29/04/2021,Andhra Pradesh,6353841,71892,4988411,1365430,4988411
30/04/2021,Andhra Pradesh,6579034,225193,5112011,1467023,5112011
01/05/2021,Andhra Pradesh,6694297,115263,5174960,1519337,5174960
02/05/2021,Andhra Pradesh,6696325,2028,5176393,1519932,5176393
03/05/2021,Andhra Pradesh,6732767,36442,5195851,1536916,5195851
04/05/2021,Andhra Pradesh,6748028,15261,5204180,1543848,5204180
05/05/2021,Andhra Pradesh,6947225,199197,5273196,1674029,5273196
06/05/2021,Andhra Pradesh,7140106,192881,5345545,1794561,5345545
07/05/2021,Andhra Pradesh,7255219,115113,5393064,1862155,5393064
08/05/2021,Andhra Pradesh,7410800,155581,5436592,1974208,5436592
09/05/2021,Andhra Pradesh,7425692,14892,5443382,1982310,5443382
10/05/2021,Andhra Pradesh,7427778,2086,5443951,1983827,5443951
11/05/2021,Andhra Pradesh,7463899,36121,5450913,2012986,5450913
12/05/2021,Andhra Pradesh,7504394,40495,5459958,2044436,5459958
13/05/2021,Andhra Pradesh,7551945,47551,5470083,2081862,5470083
14/05/2021,Andhra Pradesh,7570886,18941,5474544,2096342,5474544
15/05/2021,Andhra Pradesh,7651927,81041,5484714,2167213,5484714
16/05/2021,Andhra Pradesh,7664356,12429,5487757,2176599,5487757
17/05/2021,Andhra Pradesh,7731254,66898,5504954,2226300,5504954
18/05/2021,Andhra Pradesh,7799705,68451,5518465,2281240,5518465
19/05/2021,Andhra Pradesh,7835404,35699,5529872,2305532,5529872
20/05/2021,Andhra Pradesh,7858242,22838,5540108,2318134,5540108
21/05/2021,Andhra Pradesh,7893522,35280,5553124,2340398,5553124
22/05/2021,Andhra Pradesh,7912356,18834,5564360,2347996,5564360
23/05/2021,Andhra Pradesh,7916347,3991,5565702,2350645,5565702
24/05/2021,Andhra Pradesh,8024687,108340,5657964,2366723,5657964
25/05/2021,Andhra Pradesh,8166313,141626,5791183,2375130,5791183
26/05/2021,Andhra Pradesh,8461498,295185,6077585,2383913,6077585
27/05/2021,Andhra Pradesh,9041673,580175,6646298,2395375,6646298
28/05/2021,Andhra Pradesh,9489396,447723,7076650,2412746,7076650
29/05/2021,Andhra Pradesh,9756270,266874,7274735,2481535,7274735
30/05/2021,Andhra Pradesh,9772924,16654,7288465,2484459,7288465
31/05/2021,Andhra Pradesh,9868747,95823,7356423,2512324,7356423
01/06/2021,Andhra Pradesh,10083415,214668,7553586,2529829,7553586
02/06/2021,Andhra Pradesh,10243842,160427,7696078,2547764,7696078
03/06/2021,Andhra Pradesh,10341301,97459,7786969,2554332,7786969
04/06/2021,Andhra Pradesh,10708410,367109,8141170,2567240,8141170
05/06/2021,Andhra Pradesh,10803822,95412,8231348,2572474,8231348
06/06/2021,Andhra Pradesh,10869971,66149,8293652,2576319,8293652
07/06/2021,Andhra Pradesh,11013621,143650,8429887,2583734,8429887
08/06/2021,Andhra Pradesh,11059995,46374,8472406,2587589,8472406
09/06/2021,Andhra Pradesh,11234803,174808,8637923,2596880,8637923
10/06/2021,Andhra Pradesh,11496440,261637,8891341,2605099,8891341
11/06/2021,Andhra Pradesh,11696369,199929,9085932,2610437,9085932
12/06/2021,Andhra Pradesh,11877129,180760,9257127,2620002,9257127
13/06/2021,Andhra Pradesh,11958631,81502,9335665,2622966,9335665
14/06/2021,Andhra Pradesh,12319387,360756,9683451,2635936,9683451
15/06/2021,Andhra Pradesh,12406367,86980,9765707,2640660,9765707
16/06/2021,Andhra Pradesh,12439899,33532,9795862,2644037,9795862
17/06/2021,Andhra Pradesh,12462701,22802,9817124,2645577,9817124
18/06/2021,Andhra Pradesh,12487466,24765,9838546,2648920,9838546
19/06/2021,Andhra Pradesh,12503233,15767,9850955,2652278,9850955
20/06/2021,Andhra Pradesh,13940560,1437327,11201229,2739331,11201229
21/06/2021,Andhra Pradesh,14011163,70603,11265333,2745830,11265333
22/06/2021,Andhra Pradesh,14058162,46999,11306134,2752028,11306134
23/06/2021,Andhra Pradesh,14091954,33792,11331864,2760090,11331864
24/06/2021,Andhra Pradesh,14404310,312356,11586263,2818047,11586263
25/06/2021,Andhra Pradesh,14525647,121337,11681453,2844194,
26/06/2021,Andhra Pradesh,14827546,301899,11920947,2906599,
27/06/2021,Andhra Pradesh,14868799,41253,11958632,2910167,
28/06/2021,Andhra Pradesh,15094679,225880,12120023,2974656,
29/06/2021,Andhra Pradesh,15389049,294370,12346836,3042213,
30/06/2021,Andhra Pradesh,15703354,314305,12587352,3116002,
01/07/2021,Andhra Pradesh,15985323,281969,12805075,3180248,
02/07/2021,Andhra Pradesh,16331596,346273,13098513,3233083,
03/07/2021,Andhra Pradesh,16441282,109686,13172868,3268414,
04/07/2021,Andhra Pradesh,16459822,18540,13188358,3271464,
05/07/2021,Andhra Pradesh,16582123,122301,13264570,3317553,
06/07/2021,Andhra Pradesh,16633924,51801,13298596,3335328,
07/07/2021,Andhra Pradesh,16676789,42865,13322285,3354504,
08/07/2021,Andhra Pradesh,16715911,39122,13347419,3368492,
09/07/2021,Andhra Pradesh,16752650,36739,13372990,3379660,
10/07/2021,Andhra Pradesh,16945717,193067,13472620,3473097,
11/07/2021,Andhra Pradesh,17054306,108589,13530165,3524141,
12/07/2021,Andhra Pradesh,17357400,303094,13680228,3677172,
13/07/2021,Andhra Pradesh,17589477,232077,13817568,3771909,
14/07/2021,Andhra Pradesh,18040090,450613,14191112,3848978,
15/07/2021,Andhra Pradesh,18130140,90050,14242409,3887731,
16/07/2021,Andhra Pradesh,18391785,261645,14395270,3996515,
17/07/2021,Andhra Pradesh,18625728,233943,14507747,4117981,
18/07/2021,Andhra Pradesh,18649051,23323,14513706,4135345,
19/07/2021,Andhra Pradesh,18797967,148916,14559126,4238841,
20/07/2021,Andhra Pradesh,19036238,238271,14668281,4367957,
21/07/2021,Andhra Pradesh,19154817,118579,14739379,4415438,
22/07/2021,Andhra Pradesh,19324817,170000,14818721,4506096,
23/07/2021,Andhra Pradesh,19473515,148698,14871831,4601684,
24/07/2021,Andhra Pradesh,19565589,92074,14910329,4655260,
25/07/2021,Andhra Pradesh,19570886,5297,14913421,4657465,
26/07/2021,Andhra Pradesh,20753512,1182626,15733829,5019683,
27/07/2021,Andhra Pradesh,20928087,174575,15829320,5098767,
28/07/2021,Andhra Pradesh,21025625,97538,15860970,5164655,
29/07/2021,Andhra Pradesh,21173255,147630,15906265,5266990,
30/07/2021,Andhra Pradesh,21414613,241358,15950840,5463773,
31/07/2021,Andhra Pradesh,21669393,254780,16096801,5572592,
01/08/2021,Andhra Pradesh,21887210,217817,16301072,5586138,
02/08/2021,Andhra Pradesh,22298933,411723,16567700,5731233,
03/08/2021,Andhra Pradesh,22476139,177206,16676151,5799988,
04/08/2021,Andhra Pradesh,22650260,174121,16786246,5864014,
05/08/2021,Andhra Pradesh,22822334,172074,16889200,5933134,
06/08/2021,Andhra Pradesh,23390303,567969,17319552,6070751,
07/08/2021,Andhra Pradesh,23617219,226916,17477123,6140096,
08/08/2021,Andhra Pradesh,23699006,81787,17531461,6167545,
09/08/2021,Andhra Pradesh,23842895,143889,17628583,6214312,
,,,,,,
,,,,,,
,,,,,,
,,,,,,
,,,,,,
,,,,,,
16/01/2021,Arunachal Pradesh,81,81,81,0,81
17/01/2021,Arunachal Pradesh,178,97,178,0,178
18/01/2021,Arunachal Pradesh,560,382,560,0,560
19/01/2021,Arunachal Pradesh,574,14,574,0,574
20/01/2021,Arunachal Pradesh,601,27,601,0,601
21/01/2021,Arunachal Pradesh,1154,553,1154,0,1154
22/01/2021,Arunachal Pradesh,1818,664,1818,0,1818
23/01/2021,Arunachal Pradesh,2446,628,2446,0,2446
24/01/2021,Arunachal Pradesh,2529,83,2529,0,2529
25/01/2021,Arunachal Pradesh,3442,913,3442,0,3442
26/01/2021,Arunachal Pradesh,3462,20,3462,0,3462
27/01/2021,Arunachal Pradesh,3998,536,3998,0,3998
28/01/2021,Arunachal Pradesh,5470,1472,5470,0,5470
29/01/2021,Arunachal Pradesh,6106,636,6106,0,6106
30/01/2021,Arunachal Pradesh,6491,385,6491,0,6491
31/01/2021,Arunachal Pradesh,6525,34,6525,0,6525
01/02/2021,Arunachal Pradesh,6668,143,6668,0,6668
02/02/2021,Arunachal Pradesh,6668,0,6668,0,6668
03/02/2021,Arunachal Pradesh,6758,90,6758,0,6758
04/02/2021,Arunachal Pradesh,7785,1027,7785,0,7785
05/02/2021,Arunachal Pradesh,8745,960,8745,0,8745
06/02/2021,Arunachal Pradesh,9288,543,9288,0,9288
07/02/2021,Arunachal Pradesh,9292,4,9292,0,9292
08/02/2021,Arunachal Pradesh,10438,1146,10438,0,10438
09/02/2021,Arunachal Pradesh,10465,27,10465,0,10465
10/02/2021,Arunachal Pradesh,10529,64,10529,0,10529
11/02/2021,Arunachal Pradesh,11372,843,11372,0,11372
12/02/2021,Arunachal Pradesh,12173,801,12173,0,12173
13/02/2021,Arunachal Pradesh,13707,1534,13251,456,13251
14/02/2021,Arunachal Pradesh,13730,23,13274,456,13274
15/02/2021,Arunachal Pradesh,17018,3288,15434,1584,15434
16/02/2021,Arunachal Pradesh,17130,112,15546,1584,15546
17/02/2021,Arunachal Pradesh,17136,6,15552,1584,15552
18/02/2021,Arunachal Pradesh,20421,3285,17389,3032,17389
19/02/2021,Arunachal Pradesh,23982,3561,19872,4110,19872
20/02/2021,Arunachal Pradesh,24238,256,20018,4220,20018
21/02/2021,Arunachal Pradesh,24238,0,20018,4220,20018
22/02/2021,Arunachal Pradesh,26904,2666,21550,5354,21550
23/02/2021,Arunachal Pradesh,28444,1540,22757,5687,22757
24/02/2021,Arunachal Pradesh,28468,24,22781,5687,22781
25/02/2021,Arunachal Pradesh,31209,2741,24649,6560,24649
26/02/2021,Arunachal Pradesh,32865,1656,25903,6962,25903
27/02/2021,Arunachal Pradesh,32865,0,25903,6962,25903
28/02/2021,Arunachal Pradesh,32865,0,25903,6962,25903
01/03/2021,Arunachal Pradesh,32865,0,25903,6962,25903
02/03/2021,Arunachal Pradesh,37490,4625,29841,7649,29841
03/03/2021,Arunachal Pradesh,37937,447,30253,7684,30253
04/03/2021,Arunachal Pradesh,41398,3461,33136,8262,33136
05/03/2021,Arunachal Pradesh,44881,3483,35734,9147,35734
06/03/2021,Arunachal Pradesh,46901,2020,37249,9652,37249
07/03/2021,Arunachal Pradesh,46960,59,37299,9661,37299
08/03/2021,Arunachal Pradesh,49950,2990,39451,10499,39451
09/03/2021,Arunachal Pradesh,41504,-8446,30634,10870,41504
10/03/2021,Arunachal Pradesh,41675,171,30769,10906,41675
11/03/2021,Arunachal Pradesh,44509,2834,32947,11562,44509
12/03/2021,Arunachal Pradesh,46763,2254,34659,12104,46763
13/03/2021,Arunachal Pradesh,48143,1380,35595,12548,48143
14/03/2021,Arunachal Pradesh,48215,72,35654,12561,48215
15/03/2021,Arunachal Pradesh,51378,3163,38085,13293,51378
16/03/2021,Arunachal Pradesh,63404,12026,49653,13751,49653
17/03/2021,Arunachal Pradesh,63870,466,50078,13792,50078
18/03/2021,Arunachal Pradesh,67242,3372,52511,14731,52511
19/03/2021,Arunachal Pradesh,69729,2487,54173,15556,54173
20/03/2021,Arunachal Pradesh,71994,2265,55919,16075,55919
21/03/2021,Arunachal Pradesh,72176,182,56082,16094,56082
22/03/2021,Arunachal Pradesh,75417,3241,58541,16876,58541
23/03/2021,Arunachal Pradesh,77761,2344,60221,17540,60221
24/03/2021,Arunachal Pradesh,77826,65,60269,17557,60269
25/03/2021,Arunachal Pradesh,81124,3298,62868,18256,62868
26/03/2021,Arunachal Pradesh,84011,2887,64976,19035,64976
27/03/2021,Arunachal Pradesh,86161,2150,66980,19181,66980
28/03/2021,Arunachal Pradesh,86274,113,67041,19233,67041
29/03/2021,Arunachal Pradesh,86714,440,67464,19250,67464
30/03/2021,Arunachal Pradesh,88645,1931,68649,19996,68649
31/03/2021,Arunachal Pradesh,88794,149,68791,20003,68791
01/04/2021,Arunachal Pradesh,94722,5928,73266,21456,73266
02/04/2021,Arunachal Pradesh,96882,2160,75047,21835,75047
03/04/2021,Arunachal Pradesh,100734,3852,78114,22620,78114
04/04/2021,Arunachal Pradesh,102608,1874,79783,22825,79783
05/04/2021,Arunachal Pradesh,106688,4080,82757,23931,82757
06/04/2021,Arunachal Pradesh,109164,2476,84581,24583,84581
07/04/2021,Arunachal Pradesh,113682,4518,88000,25682,88000
08/04/2021,Arunachal Pradesh,120397,6715,93106,27291,93106
09/04/2021,Arunachal Pradesh,126463,6066,97939,28524,97939
10/04/2021,Arunachal Pradesh,131302,4839,101756,29546,101756
11/04/2021,Arunachal Pradesh,134976,3674,104975,30001,104975
12/04/2021,Arunachal Pradesh,144137,9161,112551,31586,112551
13/04/2021,Arunachal Pradesh,151848,7711,118825,33023,118825
14/04/2021,Arunachal Pradesh,158012,6164,124312,33700,124312
15/04/2021,Arunachal Pradesh,161160,3148,126950,34210,126950
16/04/2021,Arunachal Pradesh,166632,5472,130812,35820,130812
17/04/2021,Arunachal Pradesh,170756,4124,133947,36809,133947
18/04/2021,Arunachal Pradesh,172614,1858,135342,37272,135342
19/04/2021,Arunachal Pradesh,180287,7673,140794,39493,140794
20/04/2021,Arunachal Pradesh,186002,5715,145098,40904,145098
21/04/2021,Arunachal Pradesh,190466,4464,148680,41786,148680
22/04/2021,Arunachal Pradesh,197443,6977,153966,43477,153966
23/04/2021,Arunachal Pradesh,204501,7058,159167,45334,159167
24/04/2021,Arunachal Pradesh,209180,4679,162665,46515,162665
25/04/2021,Arunachal Pradesh,210335,1155,163535,46800,163535
26/04/2021,Arunachal Pradesh,216717,6382,168174,48543,168174
27/04/2021,Arunachal Pradesh,222085,5368,172178,49907,172178
28/04/2021,Arunachal Pradesh,227853,5768,176888,50965,176888
29/04/2021,Arunachal Pradesh,234677,6824,182123,52554,182123
30/04/2021,Arunachal Pradesh,241423,6746,187103,54320,187103
01/05/2021,Arunachal Pradesh,245524,4101,189910,55614,189910
02/05/2021,Arunachal Pradesh,246580,1056,190514,56066,190514
03/05/2021,Arunachal Pradesh,252527,5947,193841,58686,193841
04/05/2021,Arunachal Pradesh,256929,4402,196476,60453,196476
05/05/2021,Arunachal Pradesh,261968,5039,199517,62451,199517
06/05/2021,Arunachal Pradesh,267741,5773,202965,64776,202965
07/05/2021,Arunachal Pradesh,273182,5441,205709,67473,205709
08/05/2021,Arunachal Pradesh,277640,4458,207746,69894,207746
09/05/2021,Arunachal Pradesh,278983,1343,208414,70569,208414
10/05/2021,Arunachal Pradesh,285021,6038,210862,74159,210862
11/05/2021,Arunachal Pradesh,288821,3800,212600,76221,212600
12/05/2021,Arunachal Pradesh,290786,1965,214210,76576,214210
13/05/2021,Arunachal Pradesh,293469,2683,216168,77301,216168
14/05/2021,Arunachal Pradesh,295034,1565,217389,77645,217389
15/05/2021,Arunachal Pradesh,296640,1606,218759,77881,218759
16/05/2021,Arunachal Pradesh,297055,415,219171,77884,219171
17/05/2021,Arunachal Pradesh,302578,5523,224664,77914,224664
18/05/2021,Arunachal Pradesh,308245,5667,230286,77959,230286
19/05/2021,Arunachal Pradesh,313429,5184,235462,77967,235462
20/05/2021,Arunachal Pradesh,318150,4721,240168,77982,240168
21/05/2021,Arunachal Pradesh,321367,3217,243375,77992,243375
22/05/2021,Arunachal Pradesh,323227,1860,245155,78072,245155
23/05/2021,Arunachal Pradesh,324050,823,245978,78072,245978
24/05/2021,Arunachal Pradesh,327082,3032,248988,78094,248988
25/05/2021,Arunachal Pradesh,328603,1521,250439,78164,250439
26/05/2021,Arunachal Pradesh,329432,829,251257,78175,251257
27/05/2021,Arunachal Pradesh,330440,1008,252251,78189,252251
28/05/2021,Arunachal Pradesh,331507,1067,253299,78208,253299
29/05/2021,Arunachal Pradesh,332717,1210,254447,78270,254447
30/05/2021,Arunachal Pradesh,333067,350,254795,78272,254795
31/05/2021,Arunachal Pradesh,334007,940,255678,78329,255678
01/06/2021,Arunachal Pradesh,336634,2627,258237,78397,258237
02/06/2021,Arunachal Pradesh,343311,6677,264847,78464,264847
03/06/2021,Arunachal Pradesh,351449,8138,272908,78541,272908
04/06/2021,Arunachal Pradesh,362909,11460,284334,78575,284334
05/06/2021,Arunachal Pradesh,372776,9867,294176,78600,294176
06/06/2021,Arunachal Pradesh,376761,3985,298148,78613,298148
07/06/2021,Arunachal Pradesh,384701,7940,306022,78679,306022
08/06/2021,Arunachal Pradesh,390012,5311,311287,78725,311287
09/06/2021,Arunachal Pradesh,395757,5745,316960,78797,316960
10/06/2021,Arunachal Pradesh,400648,4891,321736,78912,321736
11/06/2021,Arunachal Pradesh,405483,4835,326492,78991,326492
12/06/2021,Arunachal Pradesh,410393,4910,331364,79029,331364
13/06/2021,Arunachal Pradesh,414648,4255,335606,79042,335606
14/06/2021,Arunachal Pradesh,420935,6287,341823,79112,341823
15/06/2021,Arunachal Pradesh,426293,5358,347059,79234,347059
16/06/2021,Arunachal Pradesh,438804,12511,359462,79342,359462
17/06/2021,Arunachal Pradesh,453458,14654,374023,79435,374023
18/06/2021,Arunachal Pradesh,468875,15417,389369,79506,389369
19/06/2021,Arunachal Pradesh,478167,9292,398545,79622,398545
20/06/2021,Arunachal Pradesh,480320,2153,400684,79636,400684
21/06/2021,Arunachal Pradesh,494030,13710,414267,79763,414267
22/06/2021,Arunachal Pradesh,505027,10997,425013,80014,425013
23/06/2021,Arunachal Pradesh,517112,12085,436991,80121,436991
24/06/2021,Arunachal Pradesh,529176,12064,448592,80584,448592
25/06/2021,Arunachal Pradesh,540634,11458,459890,80744,
26/06/2021,Arunachal Pradesh,551507,10873,470168,81339,
27/06/2021,Arunachal Pradesh,557701,6194,475866,81835,
28/06/2021,Arunachal Pradesh,573002,15301,490029,82973,
29/06/2021,Arunachal Pradesh,580543,7541,496811,83732,
30/06/2021,Arunachal Pradesh,593355,12812,508826,84529,
01/07/2021,Arunachal Pradesh,604172,10817,518465,85707,
02/07/2021,Arunachal Pradesh,614505,10333,527034,87471,
03/07/2021,Arunachal Pradesh,623711,9206,534250,89461,
04/07/2021,Arunachal Pradesh,629024,5313,538776,90248,
05/07/2021,Arunachal Pradesh,643509,14485,549526,93983,
06/07/2021,Arunachal Pradesh,654032,10523,556622,97410,
07/07/2021,Arunachal Pradesh,667128,13096,565823,101305,
08/07/2021,Arunachal Pradesh,679561,12433,574598,104963,
09/07/2021,Arunachal Pradesh,691414,11853,583021,108393,
10/07/2021,Arunachal Pradesh,701667,10253,590002,111665,
11/07/2021,Arunachal Pradesh,706004,4337,593330,112674,
12/07/2021,Arunachal Pradesh,717072,11068,600139,116933,
13/07/2021,Arunachal Pradesh,726070,8998,605243,120827,
14/07/2021,Arunachal Pradesh,736247,10177,611763,124484,
15/07/2021,Arunachal Pradesh,746764,10517,617766,128998,
16/07/2021,Arunachal Pradesh,756314,9550,623036,133278,
17/07/2021,Arunachal Pradesh,763807,7493,627353,136454,
18/07/2021,Arunachal Pradesh,767031,3224,629663,137368,
19/07/2021,Arunachal Pradesh,776986,9955,635185,141801,
20/07/2021,Arunachal Pradesh,783786,6800,638759,145027,
21/07/2021,Arunachal Pradesh,791295,7509,642710,148585,
22/07/2021,Arunachal Pradesh,798628,7333,646129,152499,
23/07/2021,Arunachal Pradesh,806642,8014,649997,156645,
24/07/2021,Arunachal Pradesh,812464,5822,653324,159140,
25/07/2021,Arunachal Pradesh,815005,2541,655107,159898,
26/07/2021,Arunachal Pradesh,822087,7082,658962,163125,
27/07/2021,Arunachal Pradesh,826787,4700,661530,165257,
28/07/2021,Arunachal Pradesh,832256,5469,664317,167939,
29/07/2021,Arunachal Pradesh,836809,4553,666557,170252,
30/07/2021,Arunachal Pradesh,841615,4806,668946,172669,
31/07/2021,Arunachal Pradesh,845600,3985,671065,174535,
01/08/2021,Arunachal Pradesh,847486,1886,672680,174806,
02/08/2021,Arunachal Pradesh,852548,5062,675931,176617,
03/08/2021,Arunachal Pradesh,856238,3690,678265,177973,
04/08/2021,Arunachal Pradesh,860312,4074,680809,179503,
05/08/2021,Arunachal Pradesh,864439,4127,683244,181195,
06/08/2021,Arunachal Pradesh,868369,3930,685986,182383,
07/08/2021,Arunachal Pradesh,871407,3038,688023,183384,
08/08/2021,Arunachal Pradesh,872897,1490,689266,183631,
09/08/2021,Arunachal Pradesh,879094,6197,692475,186619,
,,,,,,
,,,,,,
,,,,,,
,,,,,,
,,,,,,
,,,,,,
16/01/2021,Assam,401,401,401,0,401
17/01/2021,Assam,466,65,466,0,466
18/01/2021,Assam,722,256,722,0,722
19/01/2021,Assam,1254,532,1254,0,1254
20/01/2021,Assam,1254,0,1254,0,1254
21/01/2021,Assam,2163,909,2163,0,2163
22/01/2021,Assam,3947,1784,3947,0,3947
23/01/2021,Assam,4061,114,4061,0,4061
24/01/2021,Assam,4416,355,4416,0,4416
25/01/2021,Assam,10886,6470,10886,0,10886
26/01/2021,Assam,11021,135,11021,0,11021
27/01/2021,Assam,12407,1386,12407,0,12407
28/01/2021,Assam,21430,9023,21430,0,21430
29/01/2021,Assam,29322,7892,29322,0,29322
30/01/2021,Assam,30573,1251,30573,0,30573
31/01/2021,Assam,30688,115,30688,0,30688
01/02/2021,Assam,32329,1641,32329,0,32329
02/02/2021,Assam,34848,2519,34848,0,34848
03/02/2021,Assam,36100,1252,36100,0,36100
04/02/2021,Assam,52645,16545,52645,0,52645
05/02/2021,Assam,68628,15983,68628,0,68628
06/02/2021,Assam,78498,9870,78498,0,78498
07/02/2021,Assam,80284,1786,80284,0,80284
08/02/2021,Assam,91026,10742,91026,0,91026
09/02/2021,Assam,100295,9269,100295,0,100295
10/02/2021,Assam,103044,2749,103044,0,103044
11/02/2021,Assam,109906,6862,109906,0,109906
12/02/2021,Assam,117506,7600,117506,0,117506
13/02/2021,Assam,124056,6550,122050,2006,122050
14/02/2021,Assam,124177,121,122161,2016,122161
15/02/2021,Assam,128424,4247,124764,3660,124764
16/02/2021,Assam,132946,4522,127777,5169,127777
17/02/2021,Assam,134325,1379,128941,5384,128941
18/02/2021,Assam,142950,8625,135328,7622,135328
19/02/2021,Assam,156552,13602,146695,9857,146695
20/02/2021,Assam,163919,7367,153329,10590,153329
21/02/2021,Assam,165621,1702,155028,10593,155028
22/02/2021,Assam,178910,13289,165031,13879,165031
23/02/2021,Assam,190166,11256,174988,15178,174988
24/02/2021,Assam,195245,5079,179344,15901,179344
25/02/2021,Assam,210946,15701,189178,21768,189178
26/02/2021,Assam,223134,12188,195376,27758,195376
27/02/2021,Assam,223134,0,195376,27758,195376
28/02/2021,Assam,223134,0,195376,27758,195376
01/03/2021,Assam,223134,0,195376,27758,195376
02/03/2021,Assam,246658,23524,216152,30506,216152
03/03/2021,Assam,268169,21511,236065,32104,236065
04/03/2021,Assam,310530,42361,272629,37901,272629
05/03/2021,Assam,354473,43943,307984,46489,307984
06/03/2021,Assam,396169,41696,343601,52568,343601
07/03/2021,Assam,407866,11697,354572,53294,354572
08/03/2021,Assam,446529,38663,385170,61359,385170
09/03/2021,Assam,423058,-23471,354644,68414,423058
10/03/2021,Assam,441178,18120,368957,72221,441178
11/03/2021,Assam,461071,19893,385001,76070,461071
12/03/2021,Assam,480338,19267,399648,80690,480338
13/03/2021,Assam,496625,16287,412421,84204,496625
14/03/2021,Assam,497722,1097,413455,84267,497722
15/03/2021,Assam,518114,20392,429664,88450,518114
16/03/2021,Assam,597787,79673,505646,92141,505646
17/03/2021,Assam,614990,17203,520961,94029,520961
18/03/2021,Assam,635553,20563,537405,98148,537405
19/03/2021,Assam,655677,20124,552023,103654,552023
20/03/2021,Assam,674602,18925,565687,108915,565687
21/03/2021,Assam,678170,3568,568629,109541,568629
22/03/2021,Assam,707326,29156,590616,116710,590616
23/03/2021,Assam,837889,130563,711817,126072,711817
24/03/2021,Assam,875007,37118,745478,129529,745478
25/03/2021,Assam,965022,90015,828339,136683,828339
26/03/2021,Assam,1020002,54980,878784,141218,878784
27/03/2021,Assam,1043681,23679,900947,142734,900947
28/03/2021,Assam,1044730,1049,901960,142770,901960
29/03/2021,Assam,1047861,3131,904676,143185,904676
30/03/2021,Assam,1080940,33079,932808,148132,932808
31/03/2021,Assam,1098355,17415,946438,151917,946438
01/04/2021,Assam,1127935,29580,970643,157292,970643
02/04/2021,Assam,1167002,39067,1002220,164782,1002220
03/04/2021,Assam,1203976,36974,1030573,173403,1030573
04/04/2021,Assam,1225287,21311,1047611,177676,1047611
05/04/2021,Assam,1262224,36937,1075940,186284,1075940
06/04/2021,Assam,1290110,27886,1097741,192369,1097741
07/04/2021,Assam,1338480,48370,1133750,204730,1133750
08/04/2021,Assam,1405074,66594,1181704,223370,1181704
09/04/2021,Assam,1454260,49186,1215483,238777,1215483
10/04/2021,Assam,1486087,31827,1236130,249957,1236130
11/04/2021,Assam,1498693,12606,1244425,254268,1244425
12/04/2021,Assam,1530751,32058,1263243,267508,1263243
13/04/2021,Assam,1549948,19197,1274714,275234,1274714
14/04/2021,Assam,1553876,3928,1276940,276936,1276940
15/04/2021,Assam,1555448,1572,1277864,277584,1277864
16/04/2021,Assam,1564454,9006,1282985,281469,1282985
17/04/2021,Assam,1586181,21727,1295462,290719,1295462
18/04/2021,Assam,1597465,11284,1302992,294473,1302992
19/04/2021,Assam,1676713,79248,1351522,325191,1351522
20/04/2021,Assam,1770372,93659,1415214,355158,1415214
21/04/2021,Assam,1824812,54440,1454891,369921,1454891
22/04/2021,Assam,1898130,73318,1508583,389547,1508583
23/04/2021,Assam,1960809,62679,1556972,403837,1556972
24/04/2021,Assam,2005823,45014,1592952,412871,1592952
25/04/2021,Assam,2020521,14698,1605126,415395,1605126
26/04/2021,Assam,2104727,84206,1664201,440526,1664201
27/04/2021,Assam,2192325,87598,1728642,463683,1728642
28/04/2021,Assam,2242653,50328,1766829,475824,1766829
29/04/2021,Assam,2349267,106614,1846567,502700,1846567
30/04/2021,Assam,2480734,131467,1946800,533934,1946800
01/05/2021,Assam,2574065,93331,2020530,553535,2020530
02/05/2021,Assam,2589899,15834,2033174,556725,2033174
03/05/2021,Assam,2675846,85947,2096948,578898,2096948
04/05/2021,Assam,2751204,75358,2152500,598704,2152500
05/05/2021,Assam,2785838,34634,2176851,608987,2176851
06/05/2021,Assam,2835452,49614,2211808,623644,2211808
07/05/2021,Assam,2919568,84116,2277554,642014,2277554
08/05/2021,Assam,3002857,83289,2346318,656539,2346318
09/05/2021,Assam,3027029,24172,2366422,660607,2366422
10/05/2021,Assam,3120516,93487,2434046,686470,2434046
11/05/2021,Assam,3197150,76634,2487465,709685,2487465
12/05/2021,Assam,3233331,36181,2518410,714921,2518410
13/05/2021,Assam,3280423,47092,2556294,724129,2556294
14/05/2021,Assam,3305992,25569,2578539,727453,2578539
15/05/2021,Assam,3362553,56561,2631676,730877,2631676
16/05/2021,Assam,3401496,38943,2670104,731392,2670104
17/05/2021,Assam,3471991,70495,2730754,741237,2730754
18/05/2021,Assam,3531930,59939,2782676,749254,2782676
19/05/2021,Assam,3569472,37542,2815640,753832,2815640
20/05/2021,Assam,3620350,50878,2859912,760438,2859912
21/05/2021,Assam,3665676,45326,2898355,767321,2898355
22/05/2021,Assam,3716056,50380,2938533,777523,2938533
23/05/2021,Assam,3753633,37577,2972648,780985,2972648
24/05/2021,Assam,3830284,76651,3034071,796213,3034071
25/05/2021,Assam,3899915,69631,3091355,808560,3091355
26/05/2021,Assam,3935243,35328,3121529,813714,3121529
27/05/2021,Assam,3981992,46749,3162794,819198,3162794
28/05/2021,Assam,4027266,45274,3203859,823407,3203859
29/05/2021,Assam,4073879,46613,3246700,827179,3246700
30/05/2021,Assam,4094193,20314,3265432,828761,3265432
31/05/2021,Assam,4137653,43460,3304493,833160,3304493
01/06/2021,Assam,4174820,37167,3337376,837444,3337376
02/06/2021,Assam,4200000,25180,3359700,840300,3359700
03/06/2021,Assam,4235371,35371,3392421,842950,3392421
04/06/2021,Assam,4274481,39110,3429205,845276,3429205
05/06/2021,Assam,4315221,40740,3467449,847772,3467449
06/06/2021,Assam,4339728,24507,3489368,850360,3489368
07/06/2021,Assam,4389697,49969,3534232,855465,3534232
08/06/2021,Assam,4451360,61663,3590740,860620,3590740
09/06/2021,Assam,4491566,40206,3623460,868106,3623460
10/06/2021,Assam,4585754,94188,3695526,890228,3695526
11/06/2021,Assam,4674511,88757,3769894,904617,3769894
12/06/2021,Assam,4758849,84338,3841521,917328,3841521
13/06/2021,Assam,4811949,53100,3883727,928222,3883727
14/06/2021,Assam,4891540,79591,3937220,954320,3937220
15/06/2021,Assam,4951863,60323,3984232,967631,3984232
16/06/2021,Assam,4998717,46854,4018537,980180,4018537
17/06/2021,Assam,5092307,93590,4089782,1002525,4089782
18/06/2021,Assam,5210614,118307,4179861,1030753,4179861
19/06/2021,Assam,5324600,113986,4269193,1055407,4269193
20/06/2021,Assam,5360385,35785,4294662,1065723,4294662
21/06/2021,Assam,5721227,360842,4635279,1085948,4635279
22/06/2021,Assam,5989078,267851,4885776,1103302,4885776
23/06/2021,Assam,6354626,365548,5233285,1121341,5233285
24/06/2021,Assam,6523851,169225,5387805,1136046,5387805
25/06/2021,Assam,6688421,164570,5535855,1152566,
26/06/2021,Assam,6841405,152984,5658679,1182726,
27/06/2021,Assam,6854797,13392,5668536,1186261,
28/06/2021,Assam,6976615,121818,5765156,1211459,
29/06/2021,Assam,7008658,32043,5785111,1223547,
30/06/2021,Assam,7022922,14264,5792056,1230866,
01/07/2021,Assam,7206783,183861,5957147,1249636,
02/07/2021,Assam,7445311,238528,6169491,1275820,
03/07/2021,Assam,7597121,151810,6302541,1294580,
04/07/2021,Assam,7629506,32385,6329978,1299528,
05/07/2021,Assam,7690157,60651,6380179,1309978,
06/07/2021,Assam,7712614,22457,6396900,1315714,
07/07/2021,Assam,7720505,7891,6402476,1318029,
08/07/2021,Assam,7730301,9796,6409336,1320965,
09/07/2021,Assam,7790895,60594,6462249,1328646,
10/07/2021,Assam,7910876,119981,6565772,1345104,
11/07/2021,Assam,8015929,105053,6663892,1352037,
12/07/2021,Assam,8264288,248359,6895245,1369043,
13/07/2021,Assam,8346086,81798,6961897,1384189,
14/07/2021,Assam,8474492,128406,7042260,1432232,
15/07/2021,Assam,8543611,69119,7073403,1470208,
16/07/2021,Assam,8643029,99418,7145077,1497952,
17/07/2021,Assam,8763717,120688,7237044,1526673,
18/07/2021,Assam,8782510,18793,7250332,1532178,
19/07/2021,Assam,8939320,156810,7382171,1557149,
20/07/2021,Assam,9084754,145434,7497592,1587162,
21/07/2021,Assam,9128219,43465,7532329,1595890,
22/07/2021,Assam,9337930,209711,7696780,1641150,
23/07/2021,Assam,9533765,195835,7850458,1683307,
24/07/2021,Assam,9669301,135536,7957718,1711583,
25/07/2021,Assam,9733328,64027,8008339,1724989,
26/07/2021,Assam,9983825,250497,8201982,1781843,
27/07/2021,Assam,10234256,250431,8393598,1840658,
28/07/2021,Assam,10341710,107454,8476245,1865465,
29/07/2021,Assam,10448906,107196,8560333,1888573,
30/07/2021,Assam,10533219,84313,8622219,1911000,
31/07/2021,Assam,10638247,105028,8708999,1929248,
01/08/2021,Assam,10826140,187893,8877144,1948996,
02/08/2021,Assam,11129239,303099,9141787,1987452,
03/08/2021,Assam,11429254,300015,9405394,2023860,
04/08/2021,Assam,11581397,152143,9535651,2045746,
05/08/2021,Assam,11846550,265153,9765007,2081543,
06/08/2021,Assam,12087826,241276,9976148,2111678,
07/08/2021,Assam,12339414,251588,10189217,2150197,
08/08/2021,Assam,12422010,82596,10260435,2161575,
09/08/2021,Assam,12703870,281860,10495293,2208577,
,,,,,,
,,,,,,
,,,,,,
,,,,,,
,,,,,,
,,,,,,
16/01/2021,Bihar,2967,2967,2967,0,2967
17/01/2021,Bihar,3700,733,3700,0,3700
18/01/2021,Bihar,7883,4183,7883,0,7883
19/01/2021,Bihar,15546,7663,15546,0,15546
20/01/2021,Bihar,16183,637,16183,0,16183
21/01/2021,Bihar,25254,9071,25254,0,25254
22/01/2021,Bihar,25773,519,25773,0,25773
23/01/2021,Bihar,38409,12636,38409,0,38409
24/01/2021,Bihar,38787,378,38787,0,38787
25/01/2021,Bihar,51676,12889,51676,0,51676
26/01/2021,Bihar,51808,132,51808,0,51808
27/01/2021,Bihar,53222,1414,53222,0,53222
28/01/2021,Bihar,70412,17190,70412,0,70412
29/01/2021,Bihar,73181,2769,73181,0,73181
30/01/2021,Bihar,105751,32570,105751,0,105751
31/01/2021,Bihar,108889,3138,108889,0,108889
01/02/2021,Bihar,144845,35956,144845,0,144845
02/02/2021,Bihar,181290,36445,181290,0,181290
03/02/2021,Bihar,219359,38069,219359,0,219359
04/02/2021,Bihar,263973,44614,263973,0,263973
05/02/2021,Bihar,308439,44466,308439,0,308439
06/02/2021,Bihar,330327,21888,330327,0,330327
07/02/2021,Bihar,335765,5438,335765,0,335765
08/02/2021,Bihar,353743,17978,353743,0,353743
09/02/2021,Bihar,373801,20058,373801,0,373801
10/02/2021,Bihar,388881,15080,388881,0,388881
11/02/2021,Bihar,409263,20382,409263,0,409263
12/02/2021,Bihar,430554,21291,430554,0,430554
13/02/2021,Bihar,451761,21207,451706,55,451706
14/02/2021,Bihar,452991,1230,452936,55,452936
15/02/2021,Bihar,483813,30822,470549,13264,470549
16/02/2021,Bihar,485733,1920,472215,13518,472215
17/02/2021,Bihar,496507,10774,481352,15155,481352
18/02/2021,Bihar,529891,33384,497328,32563,497328
19/02/2021,Bihar,547003,17112,512327,34676,512327
20/02/2021,Bihar,557762,10759,519360,38402,519360
21/02/2021,Bihar,558309,547,519787,38522,519787
22/02/2021,Bihar,579548,21239,523685,55863,523685
23/02/2021,Bihar,588882,9334,530477,58405,530477
24/02/2021,Bihar,597807,8925,538212,59595,538212
25/02/2021,Bihar,621233,23426,546161,75072,546161
26/02/2021,Bihar,637549,16316,559321,78228,559321
27/02/2021,Bihar,637549,0,559321,78228,559321
28/02/2021,Bihar,637549,0,559321,78228,559321
01/03/2021,Bihar,637549,0,559321,78228,559321
02/03/2021,Bihar,658177,20628,568137,90040,568137
03/03/2021,Bihar,689592,31415,581124,108468,581124
04/03/2021,Bihar,733670,44078,598233,135437,598233
05/03/2021,Bihar,777943,44273,618296,159647,618296
06/03/2021,Bihar,828652,50709,643684,184968,643684
07/03/2021,Bihar,830495,1843,644690,185805,644690
08/03/2021,Bihar,996855,166360,784521,212334,784521
09/03/2021,Bihar,882786,-114069,650004,232782,882786
10/03/2021,Bihar,945716,62930,695938,249778,945716
11/03/2021,Bihar,951238,5522,700136,251102,951238
12/03/2021,Bihar,1068778,117540,798011,270767,1068778
13/03/2021,Bihar,1155115,86337,864349,290766,1155115
14/03/2021,Bihar,1159704,4589,867980,291724,1159704
15/03/2021,Bihar,1238681,78977,928808,309873,1238681
16/03/2021,Bihar,1521806,283125,1197777,324029,1197777
17/03/2021,Bihar,1633471,111665,1299718,333753,1299718
18/03/2021,Bihar,1709461,75990,1364201,345260,1364201
19/03/2021,Bihar,1781915,72454,1427007,354908,1427007
20/03/2021,Bihar,1868362,86447,1502913,365449,1502913
21/03/2021,Bihar,1893344,24982,1526471,366873,1526471
22/03/2021,Bihar,1960951,67607,1588734,372217,1588734
23/03/2021,Bihar,2090147,129196,1708266,381881,1708266
24/03/2021,Bihar,2199108,108961,1810293,388815,1810293
25/03/2021,Bihar,2326623,127515,1931442,395181,1931442
26/03/2021,Bihar,2440263,113640,2039444,400819,2039444
27/03/2021,Bihar,2555647,115384,2150425,405222,2150425
28/03/2021,Bihar,2584553,28906,2179032,405521,2179032
29/03/2021,Bihar,2587193,2640,2181647,405546,2181647
30/03/2021,Bihar,2632950,45757,2225891,407059,2225891
31/03/2021,Bihar,2739610,106660,2326918,412692,2326918
01/04/2021,Bihar,2851813,112203,2433633,418180,2433633
02/04/2021,Bihar,3064854,213041,2638486,426368,2638486
03/04/2021,Bihar,3195814,130960,2763236,432578,2763236
04/04/2021,Bihar,3346839,151025,2908130,438709,2908130
05/04/2021,Bihar,3478610,131771,3031775,446835,3031775
06/04/2021,Bihar,3676143,197533,3217315,458828,3217315
07/04/2021,Bihar,3981969,305826,3500712,481257,3500712
08/04/2021,Bihar,4165803,183834,3663711,502092,3663711
09/04/2021,Bihar,4233637,67834,3721775,511862,3721775
10/04/2021,Bihar,4491227,257590,3953983,537244,3953983
11/04/2021,Bihar,4744755,253528,4188252,556503,4188252
12/04/2021,Bihar,4952445,207690,4372599,579846,4372599
13/04/2021,Bihar,5049345,96900,4456899,592446,4456899
14/04/2021,Bihar,5225646,176301,4608655,616991,4608655
15/04/2021,Bihar,5352860,127214,4714910,637950,4714910
16/04/2021,Bihar,5426287,73427,4774916,651371,4774916
17/04/2021,Bihar,5578006,151719,4895185,682821,4895185
18/04/2021,Bihar,5686374,108368,4984400,701974,4984400
19/04/2021,Bihar,5836677,150303,5099038,737639,5099038
20/04/2021,Bihar,5964087,127410,5195367,768720,5195367
21/04/2021,Bihar,6057111,93024,5265128,791983,5265128
22/04/2021,Bihar,6169648,112537,5344307,825341,5344307
23/04/2021,Bihar,6270782,101134,5415848,854934,5415848
24/04/2021,Bihar,6362064,91282,5480243,881821,5480243
25/04/2021,Bihar,6437127,75063,5534535,902592,5534535
26/04/2021,Bihar,6557857,120730,5615151,942706,5615151
27/04/2021,Bihar,6661790,103933,5686449,975341,5686449
28/04/2021,Bihar,6761471,99681,5752082,1009389,5752082
29/04/2021,Bihar,6869722,108251,5821599,1048123,5821599
30/04/2021,Bihar,6967492,97770,5881859,1085633,5881859
01/05/2021,Bihar,7047770,80278,5928725,1119045,5928725
02/05/2021,Bihar,7110550,62780,5965407,1145143,5965407
03/05/2021,Bihar,7233171,122621,6027693,1205478,6027693
04/05/2021,Bihar,7359866,126695,6092049,1267817,6092049
05/05/2021,Bihar,7475869,116003,6150797,1325072,6150797
06/05/2021,Bihar,7604097,128228,6212706,1391391,6212706
07/05/2021,Bihar,7698767,94670,6261291,1437476,6261291
08/05/2021,Bihar,7782756,83989,6304398,1478358,6304398
09/05/2021,Bihar,7905698,122942,6411990,1493708,6411990
10/05/2021,Bihar,8108459,202761,6552924,1555535,6552924
11/05/2021,Bihar,8289734,181275,6669849,1619885,6669849
12/05/2021,Bihar,8410850,121116,6771938,1638912,6771938
13/05/2021,Bihar,8568033,157183,6907777,1660256,6907777
14/05/2021,Bihar,8713263,145230,7038183,1675080,7038183
15/05/2021,Bihar,8869524,156261,7180068,1689456,7180068
16/05/2021,Bihar,8994996,125472,7303994,1691002,7303994
17/05/2021,Bihar,9108969,113973,7411900,1697069,7411900
18/05/2021,Bihar,9188143,79174,7483076,1705067,7483076
19/05/2021,Bihar,9244503,56360,7533234,1711269,7533234
20/05/2021,Bihar,9364319,119816,7649684,1714635,7649684
21/05/2021,Bihar,9461804,97485,7740228,1721576,7740228
22/05/2021,Bihar,9521984,60180,7792417,1729567,7792417
23/05/2021,Bihar,9680319,158335,7946124,1734195,7946124
24/05/2021,Bihar,9866975,186656,8126351,1740624,8126351
25/05/2021,Bihar,9988331,121356,8240377,1747954,8240377
26/05/2021,Bihar,10065594,77263,8310987,1754607,8310987
27/05/2021,Bihar,10117955,52361,8358232,1759723,8358232
28/05/2021,Bihar,10151853,33898,8387278,1764575,8387278
29/05/2021,Bihar,10204573,52720,8431414,1773159,8431414
30/05/2021,Bihar,10247415,42842,8467861,1779554,8467861
31/05/2021,Bihar,10307600,60185,8516097,1791503,8516097
01/06/2021,Bihar,10366689,59089,8563603,1803086,8563603
02/06/2021,Bihar,10424975,58286,8612656,1812319,8612656
03/06/2021,Bihar,10585288,160313,8764409,1820879,8764409
04/06/2021,Bihar,10772252,186964,8941673,1830579,8941673
05/06/2021,Bihar,10922525,150273,9083469,1839056,9083469
06/06/2021,Bihar,11030034,107509,9183267,1846767,9183267
07/06/2021,Bihar,11134737,104703,9277636,1857101,9277636
08/06/2021,Bihar,11231592,96855,9362801,1868791,9362801
09/06/2021,Bihar,11409331,177739,9530621,1878710,9530621
10/06/2021,Bihar,11599819,190488,9712352,1887467,9712352
11/06/2021,Bihar,11778969,179150,9881658,1897311,9881658
12/06/2021,Bihar,11938798,159829,10032415,1906383,10032415
13/06/2021,Bihar,12032029,93231,10119417,1912612,10119417
14/06/2021,Bihar,12133333,101304,10210633,1922700,10210633
15/06/2021,Bihar,12205407,72074,10273357,1932050,10273357
16/06/2021,Bihar,12716811,511404,10763130,1953681,10763130
17/06/2021,Bihar,12982413,265602,10995411,1987002,10995411
18/06/2021,Bihar,13174680,192267,11158741,2015939,11158741
19/06/2021,Bihar,13509656,334976,11471642,2038014,11471642
20/06/2021,Bihar,13680378,170722,11630826,2049552,11630826
21/06/2021,Bihar,14235058,554680,12161634,2073424,12161634
22/06/2021,Bihar,14642396,407338,12546864,2095532,12546864
23/06/2021,Bihar,14978417,336021,12863306,2115111,12863306
24/06/2021,Bihar,15264572,286155,13127210,2137362,13127210
25/06/2021,Bihar,15512516,247944,13355865,2156651,
26/06/2021,Bihar,15683198,170682,13508016,2175182,
27/06/2021,Bihar,15744915,61717,13562883,2182032,
28/06/2021,Bihar,15802730,57815,13608219,2194511,
29/06/2021,Bihar,15856079,53349,13650265,2205814,
30/06/2021,Bihar,15899022,42943,13683539,2215483,
01/07/2021,Bihar,16116113,217091,13863804,2252309,
02/07/2021,Bihar,16716028,599915,14384051,2331977,
03/07/2021,Bihar,17118573,402545,14723129,2395444,
04/07/2021,Bihar,17255736,137163,14835284,2420452,
05/07/2021,Bihar,17384095,128359,14935067,2449028,
06/07/2021,Bihar,17526845,142750,15046903,2479942,
07/07/2021,Bihar,17610100,83255,15113068,2497032,
08/07/2021,Bihar,18063158,453058,15479479,2583679,
09/07/2021,Bihar,18380464,317306,15741778,2638686,
10/07/2021,Bihar,18555157,174693,15881330,2673827,
11/07/2021,Bihar,18592326,37169,15907215,2685111,
12/07/2021,Bihar,18943852,351526,16191133,2752719,
13/07/2021,Bihar,19094504,150652,16313606,2780898,
14/07/2021,Bihar,19302470,207966,16477106,2825364,
15/07/2021,Bihar,19783157,480687,16847635,2935522,
16/07/2021,Bihar,20092154,308997,17088089,3004065,
17/07/2021,Bihar,20663069,570915,17553230,3109839,
18/07/2021,Bihar,20914922,251853,17761503,3153419,
19/07/2021,Bihar,21339603,424681,18112947,3226656,
20/07/2021,Bihar,21518602,178999,18257434,3261168,
21/07/2021,Bihar,21549709,31107,18282135,3267574,
22/07/2021,Bihar,21652372,102663,18344999,3307373,
23/07/2021,Bihar,21715582,63210,18385807,3329775,
24/07/2021,Bihar,22055218,339636,18652095,3403123,
25/07/2021,Bihar,22521082,465864,19020216,3500866,
26/07/2021,Bihar,22873038,351956,19299851,3573187,
27/07/2021,Bihar,23113597,240559,19489196,3624401,
28/07/2021,Bihar,23270179,156582,19604300,3665879,
29/07/2021,Bihar,23662515,392336,19910198,3752317,
30/07/2021,Bihar,23969818,307303,20156249,3813569,
31/07/2021,Bihar,24442464,472646,20551758,3890706,
01/08/2021,Bihar,24699839,257375,20779993,3919846,
02/08/2021,Bihar,24886946,187107,20925271,3961675,
03/08/2021,Bihar,24997957,111011,21000662,3997295,
04/08/2021,Bihar,25401755,403798,21321757,4079998,
05/08/2021,Bihar,26174182,772427,21967887,4206295,
06/08/2021,Bihar,26793524,619342,22499306,4294218,
07/08/2021,Bihar,27345184,551660,22945519,4399665,
08/08/2021,Bihar,27628084,282900,23181822,4446262,
09/08/2021,Bihar,27834939,206855,23350171,4484768,
,,,,,,
,,,,,,
,,,,,,
,,,,,,
,,,,,,
,,,,,,
16/01/2021,Chandigarh,120,120,120,0,120
17/01/2021,Chandigarh,120,0,120,0,120
18/01/2021,Chandigarh,158,38,158,0,158
19/01/2021,Chandigarh,165,7,165,0,165
20/01/2021,Chandigarh,165,0,165,0,165
21/01/2021,Chandigarh,281,116,281,0,281
22/01/2021,Chandigarh,507,226,507,0,507
23/01/2021,Chandigarh,790,283,790,0,790
24/01/2021,Chandigarh,797,7,797,0,797
25/01/2021,Chandigarh,1172,375,1172,0,1172
26/01/2021,Chandigarh,1174,2,1174,0,1174
27/01/2021,Chandigarh,1519,345,1519,0,1519
28/01/2021,Chandigarh,1821,302,1821,0,1821
29/01/2021,Chandigarh,1874,53,1874,0,1874
30/01/2021,Chandigarh,2206,332,2206,0,2206
31/01/2021,Chandigarh,2217,11,2217,0,2217
01/02/2021,Chandigarh,2390,173,2390,0,2390
02/02/2021,Chandigarh,2492,102,2492,0,2492
03/02/2021,Chandigarh,2808,316,2808,0,2808
04/02/2021,Chandigarh,3150,342,3150,0,3150
05/02/2021,Chandigarh,3511,361,3511,0,3511
06/02/2021,Chandigarh,3858,347,3858,0,3858
07/02/2021,Chandigarh,3858,0,3858,0,3858
08/02/2021,Chandigarh,4189,331,4189,0,4189
09/02/2021,Chandigarh,4571,382,4571,0,4571
10/02/2021,Chandigarh,5004,433,5004,0,5004
11/02/2021,Chandigarh,5480,476,5480,0,5480
12/02/2021,Chandigarh,6056,576,6056,0,6056
13/02/2021,Chandigarh,6826,770,6709,117,6709
14/02/2021,Chandigarh,6829,3,6712,117,6712
15/02/2021,Chandigarh,7332,503,7214,118,7214
16/02/2021,Chandigarh,8018,686,7836,182,7836
17/02/2021,Chandigarh,8561,543,8364,197,8364
18/02/2021,Chandigarh,9187,626,8789,398,8789
19/02/2021,Chandigarh,10065,878,9554,511,9554
20/02/2021,Chandigarh,11125,1060,10379,746,10379
21/02/2021,Chandigarh,11125,0,10379,746,10379
22/02/2021,Chandigarh,12291,1166,11279,1012,11279
23/02/2021,Chandigarh,13594,1303,12449,1145,12449
24/02/2021,Chandigarh,14889,1295,13675,1214,13675
25/02/2021,Chandigarh,16579,1690,15100,1479,15100
26/02/2021,Chandigarh,18567,1988,16927,1640,16927
27/02/2021,Chandigarh,18567,0,16927,1640,16927
28/02/2021,Chandigarh,18567,0,16927,1640,16927
01/03/2021,Chandigarh,18567,0,16927,1640,16927
02/03/2021,Chandigarh,21667,3100,19725,1942,19725
03/03/2021,Chandigarh,23900,2233,21765,2135,21765
04/03/2021,Chandigarh,26149,2249,23665,2484,23665
05/03/2021,Chandigarh,28397,2248,25595,2802,25595
06/03/2021,Chandigarh,30679,2282,27526,3153,27526
07/03/2021,Chandigarh,30902,223,27748,3154,27748
08/03/2021,Chandigarh,33476,2574,29863,3613,29863
09/03/2021,Chandigarh,32738,-738,28622,4116,32738
10/03/2021,Chandigarh,35205,2467,30598,4607,35205
11/03/2021,Chandigarh,35992,787,31298,4694,35992
12/03/2021,Chandigarh,38260,2268,33104,5156,38260
13/03/2021,Chandigarh,40522,2262,34856,5666,40522
14/03/2021,Chandigarh,40701,179,34965,5736,40701
15/03/2021,Chandigarh,43221,2520,36848,6373,43221
16/03/2021,Chandigarh,49179,5958,42234,6945,42234
17/03/2021,Chandigarh,57449,8270,50040,7409,50040
18/03/2021,Chandigarh,59520,2071,51658,7862,51658
19/03/2021,Chandigarh,61642,2122,53379,8263,53379
20/03/2021,Chandigarh,63645,2003,54986,8659,54986
21/03/2021,Chandigarh,63808,163,55144,8664,55144
22/03/2021,Chandigarh,65746,1938,56588,9158,56588
23/03/2021,Chandigarh,67392,1646,57782,9610,57782
24/03/2021,Chandigarh,68959,1567,58992,9967,58992
25/03/2021,Chandigarh,70827,1868,60519,10308,60519
26/03/2021,Chandigarh,72558,1731,61839,10719,61839
27/03/2021,Chandigarh,74151,1593,63168,10983,63168
28/03/2021,Chandigarh,74257,106,63269,10988,63269
29/03/2021,Chandigarh,74284,27,63294,10990,63294
30/03/2021,Chandigarh,76009,1725,64574,11435,64574
31/03/2021,Chandigarh,77711,1702,65748,11963,65748
01/04/2021,Chandigarh,81055,3344,68591,12464,68591
02/04/2021,Chandigarh,84378,3323,71565,12813,71565
03/04/2021,Chandigarh,87837,3459,74528,13309,74528
04/04/2021,Chandigarh,90843,3006,77241,13602,77241
05/04/2021,Chandigarh,94240,3397,80058,14182,80058
06/04/2021,Chandigarh,96011,1771,81444,14567,81444
07/04/2021,Chandigarh,101532,5521,85979,15553,85979
08/04/2021,Chandigarh,105815,4283,89382,16433,89382
09/04/2021,Chandigarh,110149,4334,92814,17335,92814
10/04/2021,Chandigarh,115008,4859,96744,18264,96744
11/04/2021,Chandigarh,118155,3147,99484,18671,99484
12/04/2021,Chandigarh,122941,4786,103131,19810,103131
13/04/2021,Chandigarh,126850,3909,106139,20711,106139
14/04/2021,Chandigarh,130380,3530,108803,21577,108803
15/04/2021,Chandigarh,134563,4183,111665,22898,111665
16/04/2021,Chandigarh,139146,4583,114800,24346,114800
17/04/2021,Chandigarh,143254,4108,117734,25520,117734
18/04/2021,Chandigarh,145600,2346,119500,26100,119500
19/04/2021,Chandigarh,149987,4387,122192,27795,122192
20/04/2021,Chandigarh,154584,4597,124937,29647,124937
21/04/2021,Chandigarh,158565,3981,127635,30930,127635
22/04/2021,Chandigarh,163872,5307,130884,32988,130884
23/04/2021,Chandigarh,169439,5567,134397,35042,134397
24/04/2021,Chandigarh,174721,5282,137994,36727,137994
25/04/2021,Chandigarh,178655,3934,140795,37860,140795
26/04/2021,Chandigarh,184252,5597,144305,39947,144305
27/04/2021,Chandigarh,190041,5789,148026,42015,148026
28/04/2021,Chandigarh,196055,6014,151928,44127,151928
29/04/2021,Chandigarh,201907,5852,155689,46218,155689
30/04/2021,Chandigarh,208489,6582,160071,48418,160071
01/05/2021,Chandigarh,213216,4727,163599,49617,163599
02/05/2021,Chandigarh,215894,2678,165617,50277,165617
03/05/2021,Chandigarh,220462,4568,168672,51790,168672
04/05/2021,Chandigarh,225542,5080,172057,53485,172057
05/05/2021,Chandigarh,230822,5280,175618,55204,175618
06/05/2021,Chandigarh,237473,6651,179429,58044,179429
07/05/2021,Chandigarh,243450,5977,183067,60383,183067
08/05/2021,Chandigarh,250441,6991,187445,62996,187445
09/05/2021,Chandigarh,254612,4171,190204,64408,190204
10/05/2021,Chandigarh,260309,5697,193540,66769,193540
11/05/2021,Chandigarh,265527,5218,196808,68719,196808
12/05/2021,Chandigarh,269353,3826,199576,69777,199576
13/05/2021,Chandigarh,273766,4413,202829,70937,202829
14/05/2021,Chandigarh,278699,4933,206572,72127,206572
15/05/2021,Chandigarh,284834,6135,211162,73672,211162
16/05/2021,Chandigarh,285946,1112,212260,73686,212260
17/05/2021,Chandigarh,290561,4615,216622,73939,216622
18/05/2021,Chandigarh,294430,3869,220312,74118,220312
19/05/2021,Chandigarh,298281,3851,224068,74213,224068
20/05/2021,Chandigarh,302065,3784,227748,74317,227748
21/05/2021,Chandigarh,306407,4342,231985,74422,231985
22/05/2021,Chandigarh,312342,5935,237720,74622,237720
23/05/2021,Chandigarh,315428,3086,240804,74624,240804
24/05/2021,Chandigarh,320496,5068,245841,74655,245841
25/05/2021,Chandigarh,323442,2946,248749,74693,248749
26/05/2021,Chandigarh,324892,1450,250185,74707,250185
27/05/2021,Chandigarh,329825,4933,255083,74742,255083
28/05/2021,Chandigarh,334628,4803,259802,74826,259802
29/05/2021,Chandigarh,339601,4973,264747,74854,264747
30/05/2021,Chandigarh,343466,3865,268609,74857,268609
31/05/2021,Chandigarh,349507,6041,274606,74901,274606
01/06/2021,Chandigarh,355311,5804,280378,74933,280378
02/06/2021,Chandigarh,360794,5483,285834,74960,285834
03/06/2021,Chandigarh,366709,5915,291718,74991,291718
04/06/2021,Chandigarh,372191,5482,297146,75045,297146
05/06/2021,Chandigarh,377873,5682,302775,75098,302775
06/06/2021,Chandigarh,379943,2070,304833,75110,304833
07/06/2021,Chandigarh,383353,3410,308126,75227,308126
08/06/2021,Chandigarh,384919,1566,309608,75311,309608
09/06/2021,Chandigarh,387273,2354,311860,75413,311860
10/06/2021,Chandigarh,389571,2298,314057,75514,314057
11/06/2021,Chandigarh,395515,5944,319892,75623,319892
12/06/2021,Chandigarh,401380,5865,325649,75731,325649
13/06/2021,Chandigarh,405319,3939,329564,75755,329564
14/06/2021,Chandigarh,412175,6856,336282,75893,336282
15/06/2021,Chandigarh,419164,6989,343058,76106,343058
16/06/2021,Chandigarh,425495,6331,349204,76291,349204
17/06/2021,Chandigarh,432584,7089,356082,76502,356082
18/06/2021,Chandigarh,440585,8001,363813,76772,363813
19/06/2021,Chandigarh,450057,9472,372899,77158,372899
20/06/2021,Chandigarh,453577,3520,376354,77223,376354
21/06/2021,Chandigarh,460426,6849,382966,77460,382966
22/06/2021,Chandigarh,468436,8010,390586,77850,390586
23/06/2021,Chandigarh,475527,7091,397301,78226,397301
24/06/2021,Chandigarh,482326,6799,403380,78946,403380
25/06/2021,Chandigarh,489480,7154,409614,79866,
26/06/2021,Chandigarh,498862,9382,417304,81558,
27/06/2021,Chandigarh,504126,5264,421745,82381,
28/06/2021,Chandigarh,511843,7717,427780,84063,
29/06/2021,Chandigarh,519880,8037,434020,85860,
30/06/2021,Chandigarh,526877,6997,439301,87576,
01/07/2021,Chandigarh,533897,7020,444544,89353,
02/07/2021,Chandigarh,541103,7206,449392,91711,
03/07/2021,Chandigarh,551586,10483,456634,94952,
04/07/2021,Chandigarh,558150,6564,461440,96710,
05/07/2021,Chandigarh,566601,8451,467197,99404,
06/07/2021,Chandigarh,574184,7583,472038,102146,
07/07/2021,Chandigarh,580735,6551,476076,104659,
08/07/2021,Chandigarh,586654,5919,479535,107119,
09/07/2021,Chandigarh,594496,7842,483886,110610,
10/07/2021,Chandigarh,605255,10759,490212,115043,
11/07/2021,Chandigarh,611733,6478,494636,117097,
12/07/2021,Chandigarh,620721,8988,500328,120393,
13/07/2021,Chandigarh,628577,7856,505214,123363,
14/07/2021,Chandigarh,646643,18066,520502,126141,
15/07/2021,Chandigarh,655179,8536,525981,129198,
16/07/2021,Chandigarh,664346,9167,531740,132606,
17/07/2021,Chandigarh,676154,11808,538909,137245,
18/07/2021,Chandigarh,684417,8263,544177,140240,
19/07/2021,Chandigarh,693228,8811,549385,143843,
20/07/2021,Chandigarh,703489,10261,554918,148571,
21/07/2021,Chandigarh,711040,7551,558850,152190,
22/07/2021,Chandigarh,720736,9696,563735,157001,
23/07/2021,Chandigarh,731391,10655,569452,161939,
24/07/2021,Chandigarh,745126,13735,576913,168213,
25/07/2021,Chandigarh,752626,7500,581613,171013,
26/07/2021,Chandigarh,761995,9369,587081,174914,
27/07/2021,Chandigarh,771657,9662,592744,178913,
28/07/2021,Chandigarh,780708,9051,597901,182807,
29/07/2021,Chandigarh,789355,8647,603124,186231,
30/07/2021,Chandigarh,798368,9013,608006,190362,
31/07/2021,Chandigarh,817144,18776,621982,195162,
01/08/2021,Chandigarh,844437,27293,646859,197578,
02/08/2021,Chandigarh,852218,7781,651891,200327,
03/08/2021,Chandigarh,863331,11113,659902,203429,
04/08/2021,Chandigarh,870600,7269,664509,206091,
05/08/2021,Chandigarh,878332,7732,669284,209048,
06/08/2021,Chandigarh,892796,14464,679894,212902,
07/08/2021,Chandigarh,904840,12044,686609,218231,
08/08/2021,Chandigarh,911473,6633,690815,220658,
09/08/2021,Chandigarh,923819,12346,700285,223534,
,,,,,,
,,,,,,
,,,,,,
,,,,,,
,,,,,,
,,,,,,
16/01/2021,Chhattisgarh,1040,1040,1040,0,1040
17/01/2021,Chhattisgarh,1040,0,1040,0,1040
18/01/2021,Chhattisgarh,1656,616,1656,0,1656
19/01/2021,Chhattisgarh,2014,358,2014,0,2014
20/01/2021,Chhattisgarh,3351,1337,3351,0,3351
21/01/2021,Chhattisgarh,5752,2401,5752,0,5752
22/01/2021,Chhattisgarh,5807,55,5807,0,5807
23/01/2021,Chhattisgarh,12185,6378,12185,0,12185
24/01/2021,Chhattisgarh,12506,321,12506,0,12506
25/01/2021,Chhattisgarh,24018,11512,24018,0,24018
26/01/2021,Chhattisgarh,24120,102,24120,0,24120
27/01/2021,Chhattisgarh,36363,12243,36363,0,36363
28/01/2021,Chhattisgarh,46869,10506,46869,0,46869
29/01/2021,Chhattisgarh,47318,449,47318,0,47318
30/01/2021,Chhattisgarh,57446,10128,57446,0,57446
31/01/2021,Chhattisgarh,57455,9,57455,0,57455
01/02/2021,Chhattisgarh,61482,4027,61482,0,61482
02/02/2021,Chhattisgarh,64509,3027,64509,0,64509
03/02/2021,Chhattisgarh,86044,21535,86044,0,86044
04/02/2021,Chhattisgarh,115725,29681,115725,0,115725
05/02/2021,Chhattisgarh,135072,19347,135072,0,135072
06/02/2021,Chhattisgarh,153515,18443,153515,0,153515
07/02/2021,Chhattisgarh,153531,16,153531,0,153531
08/02/2021,Chhattisgarh,168873,15342,168873,0,168873
09/02/2021,Chhattisgarh,182898,14025,182898,0,182898
10/02/2021,Chhattisgarh,201792,18894,201792,0,201792
11/02/2021,Chhattisgarh,218958,17166,218958,0,218958
12/02/2021,Chhattisgarh,234012,15054,234012,0,234012
13/02/2021,Chhattisgarh,249169,15157,248307,862,248307
14/02/2021,Chhattisgarh,250235,1066,249309,926,249309
15/02/2021,Chhattisgarh,277098,26863,271832,5266,271832
16/02/2021,Chhattisgarh,294241,17143,287420,6821,287420
17/02/2021,Chhattisgarh,312728,18487,302752,9976,302752
18/02/2021,Chhattisgarh,329628,16900,315032,14596,315032
19/02/2021,Chhattisgarh,348220,18592,331802,16418,331802
20/02/2021,Chhattisgarh,362135,13915,341230,20905,341230
21/02/2021,Chhattisgarh,363144,1009,342208,20936,342208
22/02/2021,Chhattisgarh,380439,17295,351864,28575,351864
23/02/2021,Chhattisgarh,389928,9489,358547,31381,358547
24/02/2021,Chhattisgarh,405172,15244,365643,39529,365643
25/02/2021,Chhattisgarh,420647,15475,372248,48399,372248
26/02/2021,Chhattisgarh,428473,7826,376718,51755,376718
27/02/2021,Chhattisgarh,428473,0,376718,51755,376718
28/02/2021,Chhattisgarh,428473,0,376718,51755,376718
01/03/2021,Chhattisgarh,428473,0,376718,51755,376718
02/03/2021,Chhattisgarh,459117,30644,397759,61358,397759
03/03/2021,Chhattisgarh,488780,29663,417448,71332,417448
04/03/2021,Chhattisgarh,533925,45145,445300,88625,445300
05/03/2021,Chhattisgarh,578118,44193,474620,103498,474620
06/03/2021,Chhattisgarh,632575,54457,512183,120392,512183
07/03/2021,Chhattisgarh,634619,2044,514086,120533,514086
08/03/2021,Chhattisgarh,684432,49813,551009,133423,551009
09/03/2021,Chhattisgarh,600698,-83734,456120,144578,600698
10/03/2021,Chhattisgarh,649606,48908,489919,159687,649606
11/03/2021,Chhattisgarh,654318,4712,493373,160945,654318
12/03/2021,Chhattisgarh,700964,46646,524628,176336,700964
13/03/2021,Chhattisgarh,757035,56071,565547,191488,757035
14/03/2021,Chhattisgarh,764290,7255,572176,192114,764290
15/03/2021,Chhattisgarh,840424,76134,632277,208147,840424
16/03/2021,Chhattisgarh,1043000,202576,821735,221265,821735
17/03/2021,Chhattisgarh,1155353,112353,920994,234359,920994
18/03/2021,Chhattisgarh,1233656,78303,987493,246163,987493
19/03/2021,Chhattisgarh,1300911,67255,1043993,256918,1043993
20/03/2021,Chhattisgarh,1382139,81228,1115002,267137,1115002
21/03/2021,Chhattisgarh,1390076,7937,1122049,268027,1122049
22/03/2021,Chhattisgarh,1446236,56160,1170273,275963,1170273
23/03/2021,Chhattisgarh,1492021,45785,1207717,284304,1207717
24/03/2021,Chhattisgarh,1536898,44877,1246634,290264,1246634
25/03/2021,Chhattisgarh,1596613,59715,1300439,296174,1300439
26/03/2021,Chhattisgarh,1660268,63655,1359811,300457,1359811
27/03/2021,Chhattisgarh,1773189,112921,1468773,304416,1468773
28/03/2021,Chhattisgarh,1807760,34571,1502883,304877,1502883
29/03/2021,Chhattisgarh,1808453,693,1503420,305033,1503420
30/03/2021,Chhattisgarh,1863632,55179,1554803,308829,1554803
31/03/2021,Chhattisgarh,1977918,114286,1662021,315897,1662021
01/04/2021,Chhattisgarh,2113279,135361,1791743,321536,1791743
02/04/2021,Chhattisgarh,2420539,307260,2089641,330898,2089641
03/04/2021,Chhattisgarh,2645394,224855,2307001,338393,2307001
04/04/2021,Chhattisgarh,2954955,309561,2607721,347234,2607721
05/04/2021,Chhattisgarh,3071531,116576,2718779,352752,2718779
06/04/2021,Chhattisgarh,3170579,99048,2812713,357866,2812713
07/04/2021,Chhattisgarh,3399416,228837,3031106,368310,3031106
08/04/2021,Chhattisgarh,3705558,306142,3322112,383446,3322112
09/04/2021,Chhattisgarh,3935158,229600,3540293,394865,3540293
10/04/2021,Chhattisgarh,4127809,192651,3721410,406399,3721410
11/04/2021,Chhattisgarh,4303664,175855,3888257,415407,3888257
12/04/2021,Chhattisgarh,4462366,158702,4033441,428925,4033441
13/04/2021,Chhattisgarh,4559739,97373,4121532,438207,4121532
14/04/2021,Chhattisgarh,4634362,74623,4186570,447792,4186570
15/04/2021,Chhattisgarh,4680227,45865,4223870,456357,4223870
16/04/2021,Chhattisgarh,4749614,69387,4280059,469555,4280059
17/04/2021,Chhattisgarh,4870174,120560,4376707,493467,4376707
18/04/2021,Chhattisgarh,4956412,86238,4448418,507994,4448418
19/04/2021,Chhattisgarh,5043193,86781,4516858,526335,4516858
20/04/2021,Chhattisgarh,5102706,59513,4561812,540894,4561812
21/04/2021,Chhattisgarh,5146543,43837,4594052,552491,4594052
22/04/2021,Chhattisgarh,5212126,65583,4642296,569830,4642296
23/04/2021,Chhattisgarh,5272734,60608,4686119,586615,4686119
24/04/2021,Chhattisgarh,5324210,51476,4721290,602920,4721290
25/04/2021,Chhattisgarh,5362347,38137,4746201,616146,4746201
26/04/2021,Chhattisgarh,5406298,43951,4772454,633844,4772454
27/04/2021,Chhattisgarh,5438541,32243,4791314,647227,4791314
28/04/2021,Chhattisgarh,5469617,31076,4807697,661920,4807697
29/04/2021,Chhattisgarh,5507510,37893,4823914,683596,4823914
30/04/2021,Chhattisgarh,5570909,63399,4853003,717906,4853003
01/05/2021,Chhattisgarh,5620382,49473,4876021,744361,4876021
02/05/2021,Chhattisgarh,5646987,26605,4887659,759328,4887659
03/05/2021,Chhattisgarh,5684458,37471,4902668,781790,4902668
04/05/2021,Chhattisgarh,5715512,31054,4914311,801201,4914311
05/05/2021,Chhattisgarh,5746229,30717,4925570,820659,4925570
06/05/2021,Chhattisgarh,5786848,40619,4939907,846941,4939907
07/05/2021,Chhattisgarh,5815669,28821,4950080,865589,4950080
08/05/2021,Chhattisgarh,5842656,26987,4958357,884299,4958357
09/05/2021,Chhattisgarh,5857150,14494,4963503,893647,4963503
10/05/2021,Chhattisgarh,5906806,49656,4978422,928384,4978422
11/05/2021,Chhattisgarh,5956903,50097,4993821,963082,4993821
12/05/2021,Chhattisgarh,5996204,39301,5010466,985738,5010466
13/05/2021,Chhattisgarh,6046459,50255,5028824,1017635,5028824
14/05/2021,Chhattisgarh,6095570,49111,5044873,1050697,5044873
15/05/2021,Chhattisgarh,6138265,42695,5058803,1079462,5058803
16/05/2021,Chhattisgarh,6142785,4520,5062151,1080634,5062151
17/05/2021,Chhattisgarh,6149696,6911,5067225,1082471,5067225
18/05/2021,Chhattisgarh,6155825,6129,5072140,1083685,5072140
19/05/2021,Chhattisgarh,6162226,6401,5077038,1085188,5077038
20/05/2021,Chhattisgarh,6169020,6794,5081726,1087294,5081726
21/05/2021,Chhattisgarh,6175778,6758,5086685,1089093,5086685
22/05/2021,Chhattisgarh,6183624,7846,5092839,1090785,5092839
23/05/2021,Chhattisgarh,6188816,5192,5097092,1091724,5097092
24/05/2021,Chhattisgarh,6195690,6874,5102121,1093569,5102121
25/05/2021,Chhattisgarh,6201165,5475,5105905,1095260,5105905
26/05/2021,Chhattisgarh,6207632,6467,5110865,1096767,5110865
27/05/2021,Chhattisgarh,6211851,4219,5113867,1097984,5113867
28/05/2021,Chhattisgarh,6221398,9547,5121403,1099995,5121403
29/05/2021,Chhattisgarh,6229290,7892,5127168,1102122,5127168
30/05/2021,Chhattisgarh,6233466,4176,5130182,1103284,5130182
31/05/2021,Chhattisgarh,6240528,7062,5134658,1105870,5134658
01/06/2021,Chhattisgarh,6252505,11977,5139437,1113068,5139437
02/06/2021,Chhattisgarh,6260124,7619,5143077,1117047,5143077
03/06/2021,Chhattisgarh,6267748,7624,5146027,1121721,5146027
04/06/2021,Chhattisgarh,6274404,6656,5148601,1125803,5148601
05/06/2021,Chhattisgarh,6282084,7680,5151405,1130679,5151405
06/06/2021,Chhattisgarh,6285625,3541,5152970,1132655,5152970
07/06/2021,Chhattisgarh,6290982,5357,5155182,1135800,5155182
08/06/2021,Chhattisgarh,6296915,5933,5157533,1139382,5157533
09/06/2021,Chhattisgarh,6304358,7443,5160281,1144077,5160281
10/06/2021,Chhattisgarh,6311317,6959,5162838,1148479,5162838
11/06/2021,Chhattisgarh,6318147,6830,5165344,1152803,5165344
12/06/2021,Chhattisgarh,6325547,7400,5168451,1157096,5168451
13/06/2021,Chhattisgarh,6330309,4762,5170438,1159871,5170438
14/06/2021,Chhattisgarh,6337979,7670,5173815,1164164,5173815
15/06/2021,Chhattisgarh,6344469,6490,5176603,1167866,5176603
16/06/2021,Chhattisgarh,6350848,6379,5179502,1171346,5179502
17/06/2021,Chhattisgarh,6357584,6736,5182271,1175313,5182271
18/06/2021,Chhattisgarh,6365119,7535,5185507,1179612,5185507
19/06/2021,Chhattisgarh,6375229,10110,5189635,1185594,5189635
20/06/2021,Chhattisgarh,6380490,5261,5192061,1188429,5192061
21/06/2021,Chhattisgarh,6480379,99889,5278123,1202256,5278123
22/06/2021,Chhattisgarh,6605593,125214,5386159,1219434,5386159
23/06/2021,Chhattisgarh,6783572,177979,5541241,1242331,5541241
24/06/2021,Chhattisgarh,7020698,237126,5739810,1280888,5739810
25/06/2021,Chhattisgarh,7245933,225235,5918014,1327919,
26/06/2021,Chhattisgarh,7602182,356249,6211885,1390297,
27/06/2021,Chhattisgarh,7821930,219748,6380368,1441562,
28/06/2021,Chhattisgarh,8104281,282351,6602957,1501324,
29/06/2021,Chhattisgarh,8313712,209431,6766414,1547298,
30/06/2021,Chhattisgarh,8453345,139633,6879610,1573735,
01/07/2021,Chhattisgarh,8588153,134808,6996558,1591595,
02/07/2021,Chhattisgarh,8680874,92721,7076496,1604378,
03/07/2021,Chhattisgarh,8823500,142626,7167424,1656076,
04/07/2021,Chhattisgarh,8904745,81245,7217817,1686928,
05/07/2021,Chhattisgarh,9001750,97005,7279827,1721923,
06/07/2021,Chhattisgarh,9044519,42769,7307678,1736841,
07/07/2021,Chhattisgarh,9065399,20880,7321544,1743855,
08/07/2021,Chhattisgarh,9152127,86728,7374760,1777367,
09/07/2021,Chhattisgarh,9258662,106535,7438953,1819709,
10/07/2021,Chhattisgarh,9331192,72530,7492006,1839186,
11/07/2021,Chhattisgarh,9350244,19052,7506260,1843984,
12/07/2021,Chhattisgarh,9371010,20766,7521061,1849949,
13/07/2021,Chhattisgarh,9381749,10739,7528635,1853114,
14/07/2021,Chhattisgarh,9630813,249064,7744106,1886707,
15/07/2021,Chhattisgarh,9676220,45407,7769158,1907062,
16/07/2021,Chhattisgarh,9691397,15177,7778039,1913358,
17/07/2021,Chhattisgarh,9876604,185207,7889111,1987493,
18/07/2021,Chhattisgarh,9951458,74854,7939192,2012266,
19/07/2021,Chhattisgarh,10109053,157595,8041911,2067142,
20/07/2021,Chhattisgarh,10244935,135882,8135158,2109777,
21/07/2021,Chhattisgarh,10291464,46529,8170833,2120631,
22/07/2021,Chhattisgarh,10341831,50367,8207768,2134063,
23/07/2021,Chhattisgarh,10375583,33752,8232424,2143159,
24/07/2021,Chhattisgarh,10417072,41489,8262459,2154613,
25/07/2021,Chhattisgarh,10486913,69841,8308316,2178597,
26/07/2021,Chhattisgarh,10562418,75505,8363088,2199330,
27/07/2021,Chhattisgarh,10608626,46208,8395689,2212937,
28/07/2021,Chhattisgarh,10647064,38438,8422153,2224911,
29/07/2021,Chhattisgarh,10753709,106645,8494366,2259343,
30/07/2021,Chhattisgarh,10850626,96917,8563013,2287613,
31/07/2021,Chhattisgarh,10953455,102829,8632804,2320651,
01/08/2021,Chhattisgarh,11081805,128350,8748715,2333090,
02/08/2021,Chhattisgarh,11127137,45332,8775131,2352006,
03/08/2021,Chhattisgarh,11181365,54228,8808298,2373067,
04/08/2021,Chhattisgarh,11223885,42520,8829395,2394490,
05/08/2021,Chhattisgarh,11381768,157883,8917133,2464635,
06/08/2021,Chhattisgarh,11593716,211948,9069399,2524317,
07/08/2021,Chhattisgarh,11685860,92144,9123044,2562816,
08/08/2021,Chhattisgarh,11710567,24707,9136504,2574063,
09/08/2021,Chhattisgarh,11769177,58610,9181482,2587695,
,,,,,,
,,,,,,
,,,,,,
,,,,,,
,,,,,,
,,,,,,
16/01/2021,Dadra and Nagar Haveli and Daman and Diu,23,23,23,0,23
17/01/2021,Dadra and Nagar Haveli and Daman and Diu,23,0,23,0,23
18/01/2021,Dadra and Nagar Haveli and Daman and Diu,15,-8,15,0,15
19/01/2021,Dadra and Nagar Haveli and Daman and Diu,31,16,31,0,31
20/01/2021,Dadra and Nagar Haveli and Daman and Diu,31,0,31,0,31
21/01/2021,Dadra and Nagar Haveli and Daman and Diu,78,47,78,0,78
22/01/2021,Dadra and Nagar Haveli and Daman and Diu,113,35,113,0,113
23/01/2021,Dadra and Nagar Haveli and Daman and Diu,280,167,280,0,280
24/01/2021,Dadra and Nagar Haveli and Daman and Diu,312,32,312,0,312
25/01/2021,Dadra and Nagar Haveli and Daman and Diu,362,50,362,0,362
26/01/2021,Dadra and Nagar Haveli and Daman and Diu,362,0,362,0,362
27/01/2021,Dadra and Nagar Haveli and Daman and Diu,404,42,404,0,404
28/01/2021,Dadra and Nagar Haveli and Daman and Diu,559,155,559,0,559
29/01/2021,Dadra and Nagar Haveli and Daman and Diu,706,147,706,0,706
30/01/2021,Dadra and Nagar Haveli and Daman and Diu,852,146,852,0,852
31/01/2021,Dadra and Nagar Haveli and Daman and Diu,856,4,856,0,856
01/02/2021,Dadra and Nagar Haveli and Daman and Diu,1038,182,1038,0,1038
02/02/2021,Dadra and Nagar Haveli and Daman and Diu,1181,143,1181,0,1181
03/02/2021,Dadra and Nagar Haveli and Daman and Diu,1421,240,1421,0,1421
04/02/2021,Dadra and Nagar Haveli and Daman and Diu,1681,260,1681,0,1681
05/02/2021,Dadra and Nagar Haveli and Daman and Diu,1931,250,1931,0,1931
06/02/2021,Dadra and Nagar Haveli and Daman and Diu,2255,324,2255,0,2255
07/02/2021,Dadra and Nagar Haveli and Daman and Diu,2255,0,2255,0,2255
08/02/2021,Dadra and Nagar Haveli and Daman and Diu,2329,74,2329,0,2329
09/02/2021,Dadra and Nagar Haveli and Daman and Diu,2567,238,2567,0,2567
10/02/2021,Dadra and Nagar Haveli and Daman and Diu,3309,742,3309,0,3309
11/02/2021,Dadra and Nagar Haveli and Daman and Diu,3672,363,3672,0,3672
12/02/2021,Dadra and Nagar Haveli and Daman and Diu,3931,259,3931,0,3931
13/02/2021,Dadra and Nagar Haveli and Daman and Diu,4131,200,4060,71,4060
14/02/2021,Dadra and Nagar Haveli and Daman and Diu,4131,0,4060,71,4060
15/02/2021,Dadra and Nagar Haveli and Daman and Diu,4425,294,4347,78,4347
16/02/2021,Dadra and Nagar Haveli and Daman and Diu,4754,329,4590,164,4590
17/02/2021,Dadra and Nagar Haveli and Daman and Diu,5483,729,5295,188,5295
18/02/2021,Dadra and Nagar Haveli and Daman and Diu,5776,293,5569,207,5569
19/02/2021,Dadra and Nagar Haveli and Daman and Diu,6504,728,6174,330,6174
20/02/2021,Dadra and Nagar Haveli and Daman and Diu,6841,337,6376,465,6376
21/02/2021,Dadra and Nagar Haveli and Daman and Diu,6841,0,6376,465,6376
22/02/2021,Dadra and Nagar Haveli and Daman and Diu,7003,162,6488,515,6488
23/02/2021,Dadra and Nagar Haveli and Daman and Diu,7061,58,6539,522,6539
24/02/2021,Dadra and Nagar Haveli and Daman and Diu,7135,74,6609,526,6609
25/02/2021,Dadra and Nagar Haveli and Daman and Diu,7675,540,7077,598,7077
26/02/2021,Dadra and Nagar Haveli and Daman and Diu,7978,303,7304,674,7304
27/02/2021,Dadra and Nagar Haveli and Daman and Diu,7978,0,7304,674,7304
28/02/2021,Dadra and Nagar Haveli and Daman and Diu,7978,0,7304,674,7304
01/03/2021,Dadra and Nagar Haveli and Daman and Diu,7978,0,7304,674,7304
02/03/2021,Dadra and Nagar Haveli and Daman and Diu,9433,1455,8469,964,8469
03/03/2021,Dadra and Nagar Haveli and Daman and Diu,7675,-1758,7077,598,7077
04/03/2021,Dadra and Nagar Haveli and Daman and Diu,7978,303,7304,674,7304
05/03/2021,Dadra and Nagar Haveli and Daman and Diu,7978,0,7304,674,7304
06/03/2021,Dadra and Nagar Haveli and Daman and Diu,13130,5152,11246,1884,11246
07/03/2021,Dadra and Nagar Haveli and Daman and Diu,13138,8,11254,1884,11254
08/03/2021,Dadra and Nagar Haveli and Daman and Diu,13858,720,11841,2017,11841
09/03/2021,Dadra and Nagar Haveli and Daman and Diu,12668,-1190,10402,2266,12668
10/03/2021,Dadra and Nagar Haveli and Daman and Diu,13669,1001,11023,2646,13669
11/03/2021,Dadra and Nagar Haveli and Daman and Diu,13669,0,11023,2646,13669
12/03/2021,Dadra and Nagar Haveli and Daman and Diu,14781,1112,11749,3032,14781
13/03/2021,Dadra and Nagar Haveli and Daman and Diu,15595,814,12345,3250,15595
14/03/2021,Dadra and Nagar Haveli and Daman and Diu,15595,0,12345,3250,15595
15/03/2021,Dadra and Nagar Haveli and Daman and Diu,16581,986,13044,3537,16581
16/03/2021,Dadra and Nagar Haveli and Daman and Diu,19497,2916,15828,3669,15828
17/03/2021,Dadra and Nagar Haveli and Daman and Diu,21037,1540,17143,3894,17143
18/03/2021,Dadra and Nagar Haveli and Daman and Diu,21695,658,17573,4122,17573
19/03/2021,Dadra and Nagar Haveli and Daman and Diu,22889,1194,18481,4408,18481
20/03/2021,Dadra and Nagar Haveli and Daman and Diu,23782,893,19170,4612,19170
21/03/2021,Dadra and Nagar Haveli and Daman and Diu,23840,58,19218,4622,19218
22/03/2021,Dadra and Nagar Haveli and Daman and Diu,24700,860,19992,4708,19992
23/03/2021,Dadra and Nagar Haveli and Daman and Diu,26241,1541,21322,4919,21322
24/03/2021,Dadra and Nagar Haveli and Daman and Diu,26823,582,21779,5044,21779
25/03/2021,Dadra and Nagar Haveli and Daman and Diu,27819,996,22593,5226,22593
26/03/2021,Dadra and Nagar Haveli and Daman and Diu,28419,600,23111,5308,23111
27/03/2021,Dadra and Nagar Haveli and Daman and Diu,28447,28,23138,5309,23138
28/03/2021,Dadra and Nagar Haveli and Daman and Diu,28457,10,23148,5309,23148
29/03/2021,Dadra and Nagar Haveli and Daman and Diu,29349,892,23794,5555,23794
30/03/2021,Dadra and Nagar Haveli and Daman and Diu,30198,849,24471,5727,24471
31/03/2021,Dadra and Nagar Haveli and Daman and Diu,32990,2792,27071,5919,27071
01/04/2021,Dadra and Nagar Haveli and Daman and Diu,37137,4147,30937,6200,30937
02/04/2021,Dadra and Nagar Haveli and Daman and Diu,40942,3805,34424,6518,34424
03/04/2021,Dadra and Nagar Haveli and Daman and Diu,44217,3275,37495,6722,37495
04/04/2021,Dadra and Nagar Haveli and Daman and Diu,48053,3836,40921,7132,40921
05/04/2021,Dadra and Nagar Haveli and Daman and Diu,50515,2462,43184,7331,43184
06/04/2021,Dadra and Nagar Haveli and Daman and Diu,56029,5514,48313,7716,48313
07/04/2021,Dadra and Nagar Haveli and Daman and Diu,60292,4263,52156,8136,52156
08/04/2021,Dadra and Nagar Haveli and Daman and Diu,64160,3868,55718,8442,55718
09/04/2021,Dadra and Nagar Haveli and Daman and Diu,67908,3748,59130,8778,59130
10/04/2021,Dadra and Nagar Haveli and Daman and Diu,70523,2615,61498,9025,61498
11/04/2021,Dadra and Nagar Haveli and Daman and Diu,74110,3587,64703,9407,64703
12/04/2021,Dadra and Nagar Haveli and Daman and Diu,76064,1954,66367,9697,66367
13/04/2021,Dadra and Nagar Haveli and Daman and Diu,77860,1796,67859,10001,67859
14/04/2021,Dadra and Nagar Haveli and Daman and Diu,79439,1579,69063,10376,69063
15/04/2021,Dadra and Nagar Haveli and Daman and Diu,81476,2037,70628,10848,70628
16/04/2021,Dadra and Nagar Haveli and Daman and Diu,83143,1667,71964,11179,71964
17/04/2021,Dadra and Nagar Haveli and Daman and Diu,83679,536,72365,11314,72365
18/04/2021,Dadra and Nagar Haveli and Daman and Diu,84945,1266,73240,11705,73240
19/04/2021,Dadra and Nagar Haveli and Daman and Diu,86395,1450,74293,12102,74293
20/04/2021,Dadra and Nagar Haveli and Daman and Diu,87079,684,74768,12311,74768
21/04/2021,Dadra and Nagar Haveli and Daman and Diu,88091,1012,75414,12677,75414
22/04/2021,Dadra and Nagar Haveli and Daman and Diu,89186,1095,76124,13062,76124
23/04/2021,Dadra and Nagar Haveli and Daman and Diu,90101,915,76716,13385,76716
24/04/2021,Dadra and Nagar Haveli and Daman and Diu,90450,349,76905,13545,76905
25/04/2021,Dadra and Nagar Haveli and Daman and Diu,91408,958,77374,14034,77374
26/04/2021,Dadra and Nagar Haveli and Daman and Diu,92300,892,77814,14486,77814
27/04/2021,Dadra and Nagar Haveli and Daman and Diu,93189,889,78216,14973,78216
28/04/2021,Dadra and Nagar Haveli and Daman and Diu,94148,959,78680,15468,78680
29/04/2021,Dadra and Nagar Haveli and Daman and Diu,94676,528,78893,15783,78893
30/04/2021,Dadra and Nagar Haveli and Daman and Diu,94676,0,78893,15783,78893
01/05/2021,Dadra and Nagar Haveli and Daman and Diu,96320,1644,79753,16567,79753
02/05/2021,Dadra and Nagar Haveli and Daman and Diu,96619,299,79890,16729,79890
03/05/2021,Dadra and Nagar Haveli and Daman and Diu,97465,846,80227,17238,80227
04/05/2021,Dadra and Nagar Haveli and Daman and Diu,98306,841,80554,17752,80554
05/05/2021,Dadra and Nagar Haveli and Daman and Diu,99304,998,80984,18320,80984
06/05/2021,Dadra and Nagar Haveli and Daman and Diu,100560,1256,81425,19135,81425
07/05/2021,Dadra and Nagar Haveli and Daman and Diu,102229,1669,82133,20096,82133
08/05/2021,Dadra and Nagar Haveli and Daman and Diu,103338,1109,82566,20772,82566
09/05/2021,Dadra and Nagar Haveli and Daman and Diu,103786,448,82726,21060,82726
10/05/2021,Dadra and Nagar Haveli and Daman and Diu,104954,1168,83125,21829,83125
11/05/2021,Dadra and Nagar Haveli and Daman and Diu,105912,958,83422,22490,83422
12/05/2021,Dadra and Nagar Haveli and Daman and Diu,106625,713,83791,22834,83791
13/05/2021,Dadra and Nagar Haveli and Daman and Diu,109633,3008,85968,23665,85968
14/05/2021,Dadra and Nagar Haveli and Daman and Diu,113326,3693,88556,24770,88556
15/05/2021,Dadra and Nagar Haveli and Daman and Diu,117518,4192,91647,25871,91647
16/05/2021,Dadra and Nagar Haveli and Daman and Diu,120646,3128,94759,25887,94759
17/05/2021,Dadra and Nagar Haveli and Daman and Diu,123420,2774,97527,25893,97527
18/05/2021,Dadra and Nagar Haveli and Daman and Diu,123865,445,97967,25898,97967
19/05/2021,Dadra and Nagar Haveli and Daman and Diu,126803,2938,100902,25901,100902
20/05/2021,Dadra and Nagar Haveli and Daman and Diu,133618,6815,107711,25907,107711
21/05/2021,Dadra and Nagar Haveli and Daman and Diu,140028,6410,114121,25907,114121
22/05/2021,Dadra and Nagar Haveli and Daman and Diu,146279,6251,120370,25909,120370
23/05/2021,Dadra and Nagar Haveli and Daman and Diu,150932,4653,125022,25910,125022
24/05/2021,Dadra and Nagar Haveli and Daman and Diu,156860,5928,130945,25915,130945
25/05/2021,Dadra and Nagar Haveli and Daman and Diu,162836,5976,136916,25920,136916
26/05/2021,Dadra and Nagar Haveli and Daman and Diu,168731,5895,142805,25926,142805
27/05/2021,Dadra and Nagar Haveli and Daman and Diu,174518,5787,148574,25944,148574
28/05/2021,Dadra and Nagar Haveli and Daman and Diu,180694,6176,154743,25951,154743
29/05/2021,Dadra and Nagar Haveli and Daman and Diu,186645,5951,160687,25958,160687
30/05/2021,Dadra and Nagar Haveli and Daman and Diu,189815,3170,163856,25959,163856
31/05/2021,Dadra and Nagar Haveli and Daman and Diu,196079,6264,170105,25974,170105
01/06/2021,Dadra and Nagar Haveli and Daman and Diu,202000,5921,176010,25990,176010
02/06/2021,Dadra and Nagar Haveli and Daman and Diu,207670,5670,181665,26005,181665
03/06/2021,Dadra and Nagar Haveli and Daman and Diu,211798,4128,185784,26014,185784
04/06/2021,Dadra and Nagar Haveli and Daman and Diu,215802,4004,189765,26037,189765
05/06/2021,Dadra and Nagar Haveli and Daman and Diu,223040,7238,196978,26062,196978
06/06/2021,Dadra and Nagar Haveli and Daman and Diu,223524,484,197457,26067,197457
07/06/2021,Dadra and Nagar Haveli and Daman and Diu,229256,5732,203171,26085,203171
08/06/2021,Dadra and Nagar Haveli and Daman and Diu,235270,6014,209124,26146,209124
09/06/2021,Dadra and Nagar Haveli and Daman and Diu,240179,4909,214014,26165,214014
10/06/2021,Dadra and Nagar Haveli and Daman and Diu,245100,4921,218904,26196,218904
11/06/2021,Dadra and Nagar Haveli and Daman and Diu,254764,9664,228473,26291,228473
12/06/2021,Dadra and Nagar Haveli and Daman and Diu,266651,11887,240306,26345,240306
13/06/2021,Dadra and Nagar Haveli and Daman and Diu,266969,318,240620,26349,240620
14/06/2021,Dadra and Nagar Haveli and Daman and Diu,272199,5230,245784,26415,245784
15/06/2021,Dadra and Nagar Haveli and Daman and Diu,278954,6755,252456,26498,252456
16/06/2021,Dadra and Nagar Haveli and Daman and Diu,284862,5908,258254,26608,258254
17/06/2021,Dadra and Nagar Haveli and Daman and Diu,290875,6013,264197,26678,264197
18/06/2021,Dadra and Nagar Haveli and Daman and Diu,297644,6769,270889,26755,270889
19/06/2021,Dadra and Nagar Haveli and Daman and Diu,308375,10731,281451,26924,281451
,,,,,,
21/06/2021,Dadra and Nagar Haveli and Daman and Diu,317267,317267,290224,27043,290224
22/06/2021,Dadra and Nagar Haveli and Daman and Diu,325006,7739,297701,27305,297701
23/06/2021,Dadra and Nagar Haveli and Daman and Diu,332131,7125,304552,27579,304552
24/06/2021,Dadra and Nagar Haveli and Daman and Diu,341048,8917,312751,28297,312751
25/06/2021,Dadra and Nagar Haveli and Daman and Diu,358072,17024,328407,29665,
26/06/2021,Dadra and Nagar Haveli and Daman and Diu,373369,15297,341459,31910,
27/06/2021,Dadra and Nagar Haveli and Daman and Diu,379687,6318,346721,32966,
28/06/2021,Dadra and Nagar Haveli and Daman and Diu,395486,15799,359960,35526,
29/06/2021,Dadra and Nagar Haveli and Daman and Diu,410791,15305,372906,37885,
30/06/2021,Dadra and Nagar Haveli and Daman and Diu,427328,16537,387093,40235,
01/07/2021,Dadra and Nagar Haveli and Daman and Diu,440380,13052,397956,42424,
02/07/2021,Dadra and Nagar Haveli and Daman and Diu,452556,12176,407860,44696,
03/07/2021,Dadra and Nagar Haveli and Daman and Diu,466349,13793,418716,47633,
04/07/2021,Dadra and Nagar Haveli and Daman and Diu,470444,4095,422031,48413,
05/07/2021,Dadra and Nagar Haveli and Daman and Diu,480984,10540,430117,50867,
06/07/2021,Dadra and Nagar Haveli and Daman and Diu,490259,9275,437350,52909,
07/07/2021,Dadra and Nagar Haveli and Daman and Diu,498827,8568,444220,54607,
08/07/2021,Dadra and Nagar Haveli and Daman and Diu,507064,8237,450935,56129,
09/07/2021,Dadra and Nagar Haveli and Daman and Diu,515931,8867,458057,57874,
10/07/2021,Dadra and Nagar Haveli and Daman and Diu,526065,10134,466297,59768,
11/07/2021,Dadra and Nagar Haveli and Daman and Diu,529280,3215,468945,60335,
12/07/2021,Dadra and Nagar Haveli and Daman and Diu,537625,8345,476046,61579,
13/07/2021,Dadra and Nagar Haveli and Daman and Diu,545506,7881,482903,62603,
14/07/2021,Dadra and Nagar Haveli and Daman and Diu,556914,11408,493223,63691,
15/07/2021,Dadra and Nagar Haveli and Daman and Diu,563640,6726,499125,64515,
16/07/2021,Dadra and Nagar Haveli and Daman and Diu,571175,7535,505750,65425,
17/07/2021,Dadra and Nagar Haveli and Daman and Diu,577408,6233,510853,66555,
18/07/2021,Dadra and Nagar Haveli and Daman and Diu,578466,1058,511641,66825,
19/07/2021,Dadra and Nagar Haveli and Daman and Diu,582330,3864,514780,67550,
20/07/2021,Dadra and Nagar Haveli and Daman and Diu,586391,4061,518038,68353,
21/07/2021,Dadra and Nagar Haveli and Daman and Diu,589138,2747,520184,68954,
22/07/2021,Dadra and Nagar Haveli and Daman and Diu,593122,3984,523395,69727,
23/07/2021,Dadra and Nagar Haveli and Daman and Diu,597203,4081,526635,70568,
24/07/2021,Dadra and Nagar Haveli and Daman and Diu,601578,4375,530226,71352,
25/07/2021,Dadra and Nagar Haveli and Daman and Diu,602615,1037,531096,71519,
26/07/2021,Dadra and Nagar Haveli and Daman and Diu,606626,4011,534491,72135,
27/07/2021,Dadra and Nagar Haveli and Daman and Diu,611269,4643,538600,72669,
28/07/2021,Dadra and Nagar Haveli and Daman and Diu,615500,4231,542326,73174,
29/07/2021,Dadra and Nagar Haveli and Daman and Diu,619866,4366,546225,73641,
30/07/2021,Dadra and Nagar Haveli and Daman and Diu,624332,4466,550157,74175,
31/07/2021,Dadra and Nagar Haveli and Daman and Diu,629887,5555,555117,74770,
01/08/2021,Dadra and Nagar Haveli and Daman and Diu,632753,2866,557791,74962,
02/08/2021,Dadra and Nagar Haveli and Daman and Diu,636961,4208,561594,75367,
03/08/2021,Dadra and Nagar Haveli and Daman and Diu,641218,4257,565492,75726,
04/08/2021,Dadra and Nagar Haveli and Daman and Diu,644843,3625,568728,76115,
05/08/2021,Dadra and Nagar Haveli and Daman and Diu,366946,-277897,331471,35475,
06/08/2021,Dadra and Nagar Haveli and Daman and Diu,653596,286650,576155,77441,
07/08/2021,Dadra and Nagar Haveli and Daman and Diu,659199,5603,580287,78912,
08/08/2021,Dadra and Nagar Haveli and Daman and Diu,660860,1661,581361,79499,
09/08/2021,Dadra and Nagar Haveli and Daman and Diu,665221,4361,584370,80851,
,,,,,,
,,,,,,
,,,,,,
,,,,,,
,,,,,,
,,,,,,
16/01/2021,Delhi,892,892,892,0,892
17/01/2021,Delhi,1005,113,1005,0,1005
18/01/2021,Delhi,1366,361,1366,0,1366
19/01/2021,Delhi,3041,1675,3041,0,3041
20/01/2021,Delhi,3041,0,3041,0,3041
21/01/2021,Delhi,5308,2267,5308,0,5308
22/01/2021,Delhi,5331,23,5331,0,5331
23/01/2021,Delhi,12312,6981,12312,0,12312
24/01/2021,Delhi,12614,302,12614,0,12614
25/01/2021,Delhi,20373,7759,20373,0,20373
26/01/2021,Delhi,20427,54,20427,0,20427
27/01/2021,Delhi,27603,7176,27603,0,27603
28/01/2021,Delhi,35881,8278,35881,0,35881
29/01/2021,Delhi,35937,56,35937,0,35937
30/01/2021,Delhi,44758,8821,44758,0,44758
31/01/2021,Delhi,44840,82,44840,0,44840
01/02/2021,Delhi,52760,7920,52760,0,52760
02/02/2021,Delhi,62086,9326,62086,0,62086
03/02/2021,Delhi,69462,7376,69462,0,69462
04/02/2021,Delhi,78948,9486,78948,0,78948
05/02/2021,Delhi,88045,9097,88045,0,88045
06/02/2021,Delhi,97492,9447,97492,0,97492
07/02/2021,Delhi,97495,3,97495,0,97495
08/02/2021,Delhi,107116,9621,107116,0,107116
09/02/2021,Delhi,119917,12801,119917,0,119917
10/02/2021,Delhi,134600,14683,134600,0,134600
11/02/2021,Delhi,150348,15748,150348,0,150348
12/02/2021,Delhi,164976,14628,164976,0,164976
13/02/2021,Delhi,180141,15165,178174,1967,178174
14/02/2021,Delhi,180143,2,178176,1967,178176
15/02/2021,Delhi,197031,16888,192891,4140,192891
16/02/2021,Delhi,214273,17242,207447,6826,207447
17/02/2021,Delhi,231544,17271,223511,8033,223511
18/02/2021,Delhi,252843,21299,241096,11747,241096
19/02/2021,Delhi,283629,30786,270025,13604,270025
20/02/2021,Delhi,309410,25781,291137,18273,291137
21/02/2021,Delhi,309419,9,291146,18273,291146
22/02/2021,Delhi,336544,27125,312680,23864,312680
23/02/2021,Delhi,356662,20118,330559,26103,330559
24/02/2021,Delhi,375038,18376,344481,30557,344481
25/02/2021,Delhi,393471,18433,357350,36121,357350
26/02/2021,Delhi,406431,12960,367699,38732,367699
27/02/2021,Delhi,406431,0,367699,38732,367699
28/02/2021,Delhi,406431,0,367699,38732,367699
01/03/2021,Delhi,406431,0,367699,38732,367699
02/03/2021,Delhi,428377,21946,383386,44991,383386
03/03/2021,Delhi,443842,15465,394019,49823,394019
04/03/2021,Delhi,460312,16470,405213,55099,405213
05/03/2021,Delhi,475589,15277,414969,60620,414969
06/03/2021,Delhi,495154,19565,426890,68264,426890
07/03/2021,Delhi,495243,89,426957,68286,426957
08/03/2021,Delhi,516188,20945,440429,75759,440429
09/03/2021,Delhi,480051,-36137,395281,84770,480051
10/03/2021,Delhi,498624,18573,405377,93247,498624
11/03/2021,Delhi,516448,17824,415349,101099,516448
12/03/2021,Delhi,535790,19342,425063,110727,535790
13/03/2021,Delhi,560366,24576,438850,121516,560366
14/03/2021,Delhi,560392,26,438862,121530,560392
15/03/2021,Delhi,585854,25462,453718,132136,585854
16/03/2021,Delhi,682847,96993,539287,143560,539287
17/03/2021,Delhi,884805,201958,731870,152935,731870
18/03/2021,Delhi,925610,40805,758842,166768,758842
19/03/2021,Delhi,954512,28902,776830,177682,776830
20/03/2021,Delhi,1002671,48159,810104,192567,810104
21/03/2021,Delhi,1004072,1401,811261,192811,811261
22/03/2021,Delhi,1046767,42695,839942,206825,839942
23/03/2021,Delhi,1090763,43996,871370,219393,871370
24/03/2021,Delhi,1115802,25039,889115,226687,889115
25/03/2021,Delhi,1158650,42848,923806,234844,923806
26/03/2021,Delhi,1180586,21936,941076,239510,941076
27/03/2021,Delhi,1222108,41522,977993,244115,977993
28/03/2021,Delhi,1222713,605,978569,244144,978569
29/03/2021,Delhi,1222719,6,978572,244147,978572
30/03/2021,Delhi,1265239,42520,1013442,251797,1013442
31/03/2021,Delhi,1294057,28818,1034327,259730,1034327
01/04/2021,Delhi,1355145,61088,1087850,267295,1087850
02/04/2021,Delhi,1427069,71924,1152888,274181,1152888
03/04/2021,Delhi,1493167,66098,1211419,281748,1211419
04/04/2021,Delhi,1578252,85085,1290748,287504,1290748
05/04/2021,Delhi,1649227,70975,1352825,296402,1352825
06/04/2021,Delhi,1698781,49554,1396046,302735,1396046
07/04/2021,Delhi,1784983,86202,1469113,315870,1469113
08/04/2021,Delhi,1897519,112536,1565572,331947,1565572
09/04/2021,Delhi,1956686,59167,1613146,343540,1613146
10/04/2021,Delhi,2062691,106005,1705350,357341,1705350
11/04/2021,Delhi,2145719,83028,1780609,365110,1780609
12/04/2021,Delhi,2235902,90183,1855493,380409,1855493
13/04/2021,Delhi,2304883,68981,1912002,392881,1912002
14/04/2021,Delhi,2376987,72104,1971274,405713,1971274
15/04/2021,Delhi,2454871,77884,2031982,422889,2031982
16/04/2021,Delhi,2504071,49200,2065695,438376,2065695
17/04/2021,Delhi,2572685,68614,2121099,451586,2121099
18/04/2021,Delhi,2621277,48592,2162307,458970,2162307
19/04/2021,Delhi,2682092,60815,2202752,479340,2202752
20/04/2021,Delhi,2732507,50415,2238271,494236,2238271
21/04/2021,Delhi,2787116,54609,2277803,509313,2277803
22/04/2021,Delhi,2855657,68541,2325997,529660,2325997
23/04/2021,Delhi,2891857,36200,2347381,544476,2347381
24/04/2021,Delhi,2962231,70374,2395935,566296,2395935
25/04/2021,Delhi,3003477,41246,2425352,578125,2425352
26/04/2021,Delhi,3061567,58090,2461970,599597,2461970
27/04/2021,Delhi,3114832,53265,2495676,619156,2495676
28/04/2021,Delhi,3147893,33061,2512508,635385,2512508
29/04/2021,Delhi,3224828,76935,2558135,666693,2558135
30/04/2021,Delhi,3271950,47122,2581651,690299,2581651
01/05/2021,Delhi,3323249,51299,2611942,711307,2611942
02/05/2021,Delhi,3324902,1653,2613227,711675,2613227
03/05/2021,Delhi,3415728,90826,2676373,739355,2676373
04/05/2021,Delhi,3507635,91907,2742953,764682,2742953
05/05/2021,Delhi,3576091,68456,2800013,776078,2800013
06/05/2021,Delhi,3693814,117723,2883317,810497,2883317
07/05/2021,Delhi,3774068,80254,2951479,822589,2951479
08/05/2021,Delhi,3905912,131844,3044458,861454,3044458
09/05/2021,Delhi,3907469,1557,3045394,862075,3045394
10/05/2021,Delhi,4051457,143988,3142198,909259,3142198
11/05/2021,Delhi,4183896,132439,3229399,954497,3229399
12/05/2021,Delhi,4259338,75442,3292311,967027,3292311
13/05/2021,Delhi,4385905,126567,3378261,1007644,3378261
14/05/2021,Delhi,4390592,4687,3381649,1008943,3381649
15/05/2021,Delhi,4511407,120815,3464560,1046847,3464560
16/05/2021,Delhi,4603220,91813,3544850,1058370,3544850
17/05/2021,Delhi,4717683,114463,3639716,1077967,3639716
18/05/2021,Delhi,4824666,106983,3729586,1095080,3729586
19/05/2021,Delhi,4893993,69327,3791772,1102221,3791772
20/05/2021,Delhi,4972927,78934,3849484,1123443,3849484
21/05/2021,Delhi,5023829,50902,3891569,1132260,3891569
22/05/2021,Delhi,5089359,65530,3937525,1151834,3937525
23/05/2021,Delhi,5094051,4692,3941970,1152081,3941970
24/05/2021,Delhi,5149101,55050,3982667,1166434,3982667
25/05/2021,Delhi,5193420,44319,4016461,1176959,4016461
26/05/2021,Delhi,5227641,34221,4047233,1180408,4047233
27/05/2021,Delhi,5267046,39405,4081178,1185868,4081178
28/05/2021,Delhi,5298144,31098,4109416,1188728,4109416
29/05/2021,Delhi,5352466,54322,4148595,1203871,4148595
30/05/2021,Delhi,5362104,9638,4157813,1204291,4157813
31/05/2021,Delhi,5419341,57237,4194986,1224355,4194986
01/06/2021,Delhi,5469628,50287,4228359,1241269,4228359
02/06/2021,Delhi,5506534,36906,4257176,1249358,4257176
03/06/2021,Delhi,5559386,52852,4294738,1264648,4294738
04/06/2021,Delhi,5599054,39668,4329324,1269730,4329324
05/06/2021,Delhi,5656091,57037,4371075,1285016,4371075
06/06/2021,Delhi,5671497,15406,4385618,1285879,4385618
07/06/2021,Delhi,5737887,66390,4419597,1318290,4419597
08/06/2021,Delhi,5786229,48342,4445352,1340877,4445352
09/06/2021,Delhi,5834482,48253,4471099,1363383,4471099
10/06/2021,Delhi,5916278,81796,4521905,1394373,4521905
11/06/2021,Delhi,5995748,79470,4583464,1412284,4583464
12/06/2021,Delhi,6079589,83841,4638935,1440654,4638935
13/06/2021,Delhi,6094030,14441,4650867,1443163,4650867
14/06/2021,Delhi,6154661,60631,4690576,1464085,4690576
15/06/2021,Delhi,6208289,53628,4719321,1488968,4719321
16/06/2021,Delhi,6263721,55432,4756248,1507473,4756248
17/06/2021,Delhi,6355530,91809,4818228,1537302,4818228
18/06/2021,Delhi,6434195,78665,4881510,1552685,4881510
19/06/2021,Delhi,6522118,87923,4943731,1578387,4943731
20/06/2021,Delhi,6533793,11675,4953785,1580008,4953785
21/06/2021,Delhi,6611234,77441,5013438,1597796,5013438
22/06/2021,Delhi,6697233,85999,5080592,1616641,5080592
23/06/2021,Delhi,6807716,110483,5179708,1628008,5179708
24/06/2021,Delhi,6966205,158489,5318124,1648081,5318124
25/06/2021,Delhi,7121582,155377,5456691,1664891,
26/06/2021,Delhi,7329652,208070,5629446,1700206,
27/06/2021,Delhi,7339238,9586,5636415,1702823,
28/06/2021,Delhi,7543922,204684,5801102,1742820,
29/06/2021,Delhi,7747246,203324,5967019,1780227,
30/06/2021,Delhi,7893534,146288,6088879,1804655,
01/07/2021,Delhi,8051352,157818,6214708,1836644,
02/07/2021,Delhi,8212088,160736,6345189,1866899,
03/07/2021,Delhi,8373332,161244,6466496,1906836,
04/07/2021,Delhi,8382839,9507,6472151,1910688,
05/07/2021,Delhi,8463689,80850,6523882,1939807,
06/07/2021,Delhi,8498379,34690,6543046,1955333,
07/07/2021,Delhi,8520756,22377,6554851,1965905,
08/07/2021,Delhi,8679752,158996,6666282,2013470,
09/07/2021,Delhi,8810952,131200,6761634,2049318,
10/07/2021,Delhi,8890766,79814,6814195,2076571,
11/07/2021,Delhi,8901626,10860,6821204,2080422,
12/07/2021,Delhi,8937940,36314,6843441,2094499,
13/07/2021,Delhi,9067022,129082,6936013,2131009,
14/07/2021,Delhi,9153718,86696,7002464,2151254,
15/07/2021,Delhi,9186905,33187,7023654,2163251,
16/07/2021,Delhi,9274314,87409,7086069,2188245,
17/07/2021,Delhi,9346116,71802,7134416,2211700,
18/07/2021,Delhi,9357476,11360,7141467,2216009,
19/07/2021,Delhi,9383467,25991,7158176,2225291,
20/07/2021,Delhi,9455470,72003,7200320,2255150,
21/07/2021,Delhi,9518884,63414,7230289,2288595,
22/07/2021,Delhi,9567507,48623,7252529,2314978,
23/07/2021,Delhi,9603697,36190,7268264,2335433,
24/07/2021,Delhi,9673601,69904,7289525,2384076,
25/07/2021,Delhi,9684216,10615,7296521,2387695,
26/07/2021,Delhi,9741598,57382,7311091,2430507,
27/07/2021,Delhi,9779440,37842,7324923,2454517,
28/07/2021,Delhi,9837247,57807,7336542,2500705,
29/07/2021,Delhi,9909776,72529,7350096,2559680,
30/07/2021,Delhi,9965538,55762,7363608,2601930,
31/07/2021,Delhi,10047640,82102,7382742,2664898,
01/08/2021,Delhi,10104786,57146,7433097,2671689,
02/08/2021,Delhi,10198712,93926,7482001,2716711,
03/08/2021,Delhi,10295389,96677,7533335,2762054,
04/08/2021,Delhi,10381633,86244,7579306,2802327,
05/08/2021,Delhi,10471779,90146,7630307,2841472,
06/08/2021,Delhi,10559677,87898,7684071,2875606,
07/08/2021,Delhi,10679728,120051,7744261,2935467,
08/08/2021,Delhi,10690855,11127,7750023,2940832,
09/08/2021,Delhi,10836082,145227,7835546,3000536,
,,,,,,
,,,,,,
,,,,,,
,,,,,,
,,,,,,
,,,,,,
,,,,,,
16/01/2021,Goa,50,50,50,0,50
17/01/2021,Goa,50,0,50,0,50
18/01/2021,Goa,47,-3,47,0,47
19/01/2021,Goa,72,25,72,0,72
20/01/2021,Goa,72,0,72,0,72
21/01/2021,Goa,72,0,72,0,72
22/01/2021,Goa,300,228,300,0,300
23/01/2021,Goa,971,671,971,0,971
24/01/2021,Goa,1033,62,1033,0,1033
25/01/2021,Goa,1285,252,1285,0,1285
26/01/2021,Goa,1290,5,1290,0,1290
27/01/2021,Goa,1844,554,1844,0,1844
28/01/2021,Goa,2394,550,2394,0,2394
29/01/2021,Goa,2752,358,2752,0,2752
30/01/2021,Goa,3464,712,3464,0,3464
31/01/2021,Goa,3466,2,3466,0,3466
01/02/2021,Goa,3860,394,3860,0,3860
02/02/2021,Goa,4720,860,4720,0,4720
03/02/2021,Goa,5582,862,5582,0,5582
04/02/2021,Goa,6532,950,6532,0,6532
05/02/2021,Goa,7195,663,7195,0,7195
06/02/2021,Goa,7460,265,7460,0,7460
07/02/2021,Goa,7462,2,7462,0,7462
08/02/2021,Goa,7800,338,7800,0,7800
09/02/2021,Goa,8607,807,8607,0,8607
10/02/2021,Goa,9656,1049,9656,0,9656
11/02/2021,Goa,11086,1430,11086,0,11086
12/02/2021,Goa,12743,1657,12743,0,12743
13/02/2021,Goa,13586,843,13277,309,13277
14/02/2021,Goa,13586,0,13277,309,13277
15/02/2021,Goa,14279,693,13942,337,13942
16/02/2021,Goa,14463,184,14123,340,14123
17/02/2021,Goa,15040,577,14700,340,14700
18/02/2021,Goa,14303,-737,13960,343,13960
19/02/2021,Goa,16002,1699,15417,585,15417
20/02/2021,Goa,17395,1393,16122,1273,16122
21/02/2021,Goa,17395,0,16122,1273,16122
22/02/2021,Goa,18143,748,16651,1492,16651
23/02/2021,Goa,18419,276,16916,1503,16916
24/02/2021,Goa,19851,1432,17881,1970,17881
25/02/2021,Goa,21121,1270,18693,2428,18693
26/02/2021,Goa,22620,1499,19870,2750,19870
27/02/2021,Goa,22620,0,19870,2750,19870
28/02/2021,Goa,22620,0,19870,2750,19870
01/03/2021,Goa,22620,0,19870,2750,19870
02/03/2021,Goa,27005,4385,23398,3607,23398
03/03/2021,Goa,31430,4425,26860,4570,26860
04/03/2021,Goa,36170,4740,30673,5497,30673
05/03/2021,Goa,40430,4260,34005,6425,34005
06/03/2021,Goa,43800,3370,36894,6906,36894
07/03/2021,Goa,43808,8,36902,6906,36902
08/03/2021,Goa,47499,3691,40153,7346,40153
09/03/2021,Goa,43940,-3559,36027,7913,43940
10/03/2021,Goa,47253,3313,38493,8760,47253
11/03/2021,Goa,50241,2988,40416,9825,50241
12/03/2021,Goa,55587,5346,44305,11282,55587
13/03/2021,Goa,59312,3725,47645,11667,59312
14/03/2021,Goa,59323,11,47655,11668,59323
15/03/2021,Goa,64652,5329,52403,12249,64652
16/03/2021,Goa,78377,13725,65739,12638,65739
17/03/2021,Goa,85431,7054,72357,13074,72357
18/03/2021,Goa,88064,2633,74794,13270,74794
19/03/2021,Goa,91419,3355,77616,13803,77616
20/03/2021,Goa,94735,3316,80447,14288,80447
21/03/2021,Goa,94819,84,80522,14297,80522
22/03/2021,Goa,98125,3306,83315,14810,83315
23/03/2021,Goa,101464,3339,86286,15178,86286
24/03/2021,Goa,104768,3304,88974,15794,88974
25/03/2021,Goa,107821,3053,91525,16296,91525
26/03/2021,Goa,111081,3260,94110,16971,94110
27/03/2021,Goa,113726,2645,96611,17115,96611
28/03/2021,Goa,113726,0,96611,17115,96611
29/03/2021,Goa,114575,849,97343,17232,97343
30/03/2021,Goa,118688,4113,100317,18371,100317
31/03/2021,Goa,121981,3293,102595,19386,102595
01/04/2021,Goa,125601,3620,105426,20175,105426
02/04/2021,Goa,129693,4092,108867,20826,108867
03/04/2021,Goa,133134,3441,111519,21615,111519
04/04/2021,Goa,135851,2717,113879,21972,113879
05/04/2021,Goa,139746,3895,116633,23113,116633
06/04/2021,Goa,142463,2717,118691,23772,118691
07/04/2021,Goa,149580,7117,123996,25584,123996
08/04/2021,Goa,155376,5796,128428,26948,128428
09/04/2021,Goa,162057,6681,133268,28789,133268
10/04/2021,Goa,171070,9013,140385,30685,140385
11/04/2021,Goa,178329,7259,147178,31151,147178
12/04/2021,Goa,188080,9751,154523,33557,154523
13/04/2021,Goa,192563,4483,158206,34357,158206
14/04/2021,Goa,203125,10562,167443,35682,167443
15/04/2021,Goa,213122,9997,173909,39213,173909
16/04/2021,Goa,224966,11844,182574,42392,182574
17/04/2021,Goa,237156,12190,191878,45278,191878
18/04/2021,Goa,244577,7421,198368,46209,198368
19/04/2021,Goa,253784,9207,204861,48923,204861
20/04/2021,Goa,264363,10579,212256,52107,212256
21/04/2021,Goa,272843,8480,218280,54563,218280
22/04/2021,Goa,281424,8581,224561,56863,224561
23/04/2021,Goa,289688,8264,230437,59251,230437
24/04/2021,Goa,299120,9432,237544,61576,237544
25/04/2021,Goa,304009,4889,241453,62556,241453
26/04/2021,Goa,313009,9000,248280,64729,248280
27/04/2021,Goa,323213,10204,256196,67017,256196
28/04/2021,Goa,331720,8507,262802,68918,262802
29/04/2021,Goa,340659,8939,269749,70910,269749
30/04/2021,Goa,349718,9059,277125,72593,277125
01/05/2021,Goa,355269,5551,282005,73264,282005
02/05/2021,Goa,358280,3011,284560,73720,284560
03/05/2021,Goa,363592,5312,288805,74787,288805
04/05/2021,Goa,368857,5265,292908,75949,292908
05/05/2021,Goa,373997,5140,296579,77418,296579
06/05/2021,Goa,379927,5930,300663,79264,300663
07/05/2021,Goa,386450,6523,305206,81244,305206
08/05/2021,Goa,392342,5892,309334,83008,309334
09/05/2021,Goa,394413,2071,310955,83458,310955
10/05/2021,Goa,399718,5305,314583,85135,314583
11/05/2021,Goa,405500,5782,318352,87148,318352
12/05/2021,Goa,411191,5691,322251,88940,322251
13/05/2021,Goa,418484,7293,327646,90838,327646
14/05/2021,Goa,425521,7037,332990,92531,332990
15/05/2021,Goa,436458,10937,342243,94215,342243
16/05/2021,Goa,438881,2423,344615,94266,344615
17/05/2021,Goa,444923,6042,350557,94366,350557
18/05/2021,Goa,451943,7020,357502,94441,357502
19/05/2021,Goa,459632,7689,365111,94521,365111
20/05/2021,Goa,466522,6890,371961,94561,371961
21/05/2021,Goa,475384,8862,380740,94644,380740
22/05/2021,Goa,483931,8547,389263,94668,389263
23/05/2021,Goa,485579,1648,390887,94692,390887
24/05/2021,Goa,491326,5747,396608,94718,396608
25/05/2021,Goa,497180,5854,402427,94753,402427
26/05/2021,Goa,503101,5921,408309,94792,408309
27/05/2021,Goa,508928,5827,414098,94830,414098
28/05/2021,Goa,514992,6064,420107,94885,420107
29/05/2021,Goa,521480,6488,426519,94961,426519
30/05/2021,Goa,524372,2892,429393,94979,429393
31/05/2021,Goa,528955,4583,433855,95100,433855
01/06/2021,Goa,533504,4549,438285,95219,438285
02/06/2021,Goa,537792,4288,442390,95402,442390
03/06/2021,Goa,543715,5923,448111,95604,448111
04/06/2021,Goa,551988,8273,456053,95935,456053
05/06/2021,Goa,563779,11791,467529,96250,467529
06/06/2021,Goa,570434,6655,474147,96287,474147
07/06/2021,Goa,581671,11237,485171,96500,485171
08/06/2021,Goa,592178,10507,495452,96726,495452
09/06/2021,Goa,600833,8655,503890,96943,503890
10/06/2021,Goa,608564,7731,511379,97185,511379
11/06/2021,Goa,614418,5854,516897,97521,516897
12/06/2021,Goa,621644,7226,523796,97848,523796
13/06/2021,Goa,638918,17274,541029,97889,541029
14/06/2021,Goa,658193,19275,559670,98523,559670
15/06/2021,Goa,676789,18596,577925,98864,577925
16/06/2021,Goa,691969,15180,592719,99250,592719
17/06/2021,Goa,708794,16825,609077,99717,609077
18/06/2021,Goa,726686,17892,626378,100308,626378
19/06/2021,Goa,747361,20675,646436,100925,646436
20/06/2021,Goa,760206,12845,659181,101025,659181
21/06/2021,Goa,776098,15892,674546,101552,674546
22/06/2021,Goa,791272,15174,688792,102480,688792
23/06/2021,Goa,805001,13729,701689,103312,701689
24/06/2021,Goa,818202,13201,713714,104488,713714
25/06/2021,Goa,833836,15634,728178,105658,
26/06/2021,Goa,856142,22306,748351,107791,
27/06/2021,Goa,871472,15330,762729,108743,
28/06/2021,Goa,892220,20748,781063,111157,
29/06/2021,Goa,914013,21793,800268,113745,
30/06/2021,Goa,934022,20009,817485,116537,
01/07/2021,Goa,946993,12971,827800,119193,
02/07/2021,Goa,960730,13737,837780,122950,
03/07/2021,Goa,980683,19953,852875,127808,
04/07/2021,Goa,990480,9797,859902,130578,
05/07/2021,Goa,1006988,16508,870453,136535,
06/07/2021,Goa,1021435,14447,880174,141261,
07/07/2021,Goa,1036104,14669,889028,147076,
08/07/2021,Goa,1047488,11384,896123,151365,
09/07/2021,Goa,1063046,15558,904928,158118,
10/07/2021,Goa,1083489,20443,917304,166185,
11/07/2021,Goa,1096064,12575,925096,170968,
12/07/2021,Goa,1113775,17711,935694,178081,
13/07/2021,Goa,1127686,13911,943067,184619,
14/07/2021,Goa,1144976,17290,954703,190273,
15/07/2021,Goa,1155882,10906,960479,195403,
16/07/2021,Goa,1166709,10827,965882,200827,
17/07/2021,Goa,1184432,17723,975773,208659,
18/07/2021,Goa,1190638,6206,978988,211650,
19/07/2021,Goa,1202589,11951,985642,216947,
20/07/2021,Goa,1213360,10771,990912,222448,
21/07/2021,Goa,1221997,8637,994834,227163,
22/07/2021,Goa,1232518,10521,999900,232618,
23/07/2021,Goa,1243867,11349,1005102,238765,
24/07/2021,Goa,1258741,14874,1013223,245518,
25/07/2021,Goa,1265385,6644,1016953,248432,
26/07/2021,Goa,1276977,11592,1023636,253341,
27/07/2021,Goa,1286117,9140,1029078,257039,
28/07/2021,Goa,1295529,9412,1034482,261047,
29/07/2021,Goa,1304583,9054,1040080,264503,
30/07/2021,Goa,1314469,9886,1046130,268339,
31/07/2021,Goa,1327101,12632,1054705,272396,
01/08/2021,Goa,1335323,8222,1061058,274265,
02/08/2021,Goa,1343162,7839,1066012,277150,
03/08/2021,Goa,1350317,7155,1070428,279889,
04/08/2021,Goa,1356445,6128,1073972,282473,
05/08/2021,Goa,1362196,5751,1076956,285240,
06/08/2021,Goa,1370190,7994,1081299,288891,
07/08/2021,Goa,1382444,12254,1087385,295059,
08/08/2021,Goa,1387664,5220,1089646,298018,
09/08/2021,Goa,1396911,9247,1094392,302519,
,,,,,,
,,,,,,
,,,,,,
,,,,,,
,,,,,,
,,,,,,
16/01/2021,Gujarat,1146,1146,1146,0,1146
17/01/2021,Gujarat,2313,1167,2313,0,2313
18/01/2021,Gujarat,2182,-131,2182,0,2182
19/01/2021,Gujarat,4842,2660,4842,0,4842
20/01/2021,Gujarat,4877,35,4877,0,4877
21/01/2021,Gujarat,8350,3473,8350,0,8350
22/01/2021,Gujarat,13183,4833,13183,0,13183
23/01/2021,Gujarat,44873,31690,44873,0,44873
24/01/2021,Gujarat,46456,1583,46456,0,46456
25/01/2021,Gujarat,62496,16040,62496,0,62496
26/01/2021,Gujarat,62729,233,62729,0,62729
27/01/2021,Gujarat,68817,6088,68817,0,68817
28/01/2021,Gujarat,132621,63804,132621,0,132621
29/01/2021,Gujarat,187038,54417,187038,0,187038
30/01/2021,Gujarat,211551,24513,211551,0,211551
31/01/2021,Gujarat,251207,39656,251207,0,251207
01/02/2021,Gujarat,284170,32963,284170,0,284170
02/02/2021,Gujarat,306639,22469,306639,0,306639
03/02/2021,Gujarat,326450,19811,326450,0,326450
04/02/2021,Gujarat,360502,34052,360502,0,360502
05/02/2021,Gujarat,404841,44339,404841,0,404841
06/02/2021,Gujarat,448811,43970,448811,0,448811
07/02/2021,Gujarat,468838,20027,468838,0,468838
08/02/2021,Gujarat,537364,68526,537364,0,537364
09/02/2021,Gujarat,617709,80345,617709,0,617709
10/02/2021,Gujarat,683599,65890,683599,0,683599
11/02/2021,Gujarat,726174,42575,726174,0,726174
12/02/2021,Gujarat,749435,23261,749435,0,749435
13/02/2021,Gujarat,759801,10366,759799,2,759799
14/02/2021,Gujarat,761555,1754,761549,6,761549
15/02/2021,Gujarat,783293,21738,774751,8542,774751
16/02/2021,Gujarat,799296,16003,784610,14686,784610
17/02/2021,Gujarat,806425,7129,789722,16703,789722
18/02/2021,Gujarat,799523,-6902,773109,26414,773109
19/02/2021,Gujarat,843816,44293,807835,35981,807835
20/02/2021,Gujarat,869257,25441,810715,58542,810715
21/02/2021,Gujarat,870310,1053,810973,59337,810973
22/02/2021,Gujarat,884999,14689,812914,72085,812914
23/02/2021,Gujarat,892463,7464,815413,77050,815413
24/02/2021,Gujarat,896424,3961,817727,78697,817727
25/02/2021,Gujarat,943860,47436,819845,124015,819845
26/02/2021,Gujarat,989315,45455,821729,167586,821729
27/02/2021,Gujarat,989319,4,821733,167586,821733
28/02/2021,Gujarat,989369,50,821783,167586,821783
01/03/2021,Gujarat,989369,0,821783,167586,821783
02/03/2021,Gujarat,1153267,163898,956419,196848,956419
03/03/2021,Gujarat,1234893,81626,1015619,219274,1015619
04/03/2021,Gujarat,1397814,162921,1143571,254243,1143571
05/03/2021,Gujarat,1580465,182651,1284380,296085,1284380
06/03/2021,Gujarat,1745473,165008,1414609,330864,1414609
07/03/2021,Gujarat,1749600,4127,1417812,331788,1417812
08/03/2021,Gujarat,1919226,169626,1551898,367328,1551898
09/03/2021,Gujarat,1719245,-199981,1307844,411401,1719245
10/03/2021,Gujarat,1766662,47417,1332660,434002,1766662
11/03/2021,Gujarat,1776940,10278,1341652,435288,1776940
12/03/2021,Gujarat,1947430,170490,1462283,485147,1947430
13/03/2021,Gujarat,2073148,125718,1559499,513649,2073148
14/03/2021,Gujarat,2083779,10631,1568700,515079,2083779
15/03/2021,Gujarat,2231425,147646,1691481,539944,2231425
16/03/2021,Gujarat,2772614,541189,2208185,564429,2208185
17/03/2021,Gujarat,2923717,151103,2349458,574259,2349458
18/03/2021,Gujarat,3112038,188321,2521859,590179,2521859
19/03/2021,Gujarat,3309060,197022,2705730,603330,2705730
20/03/2021,Gujarat,3546628,237568,2933180,613448,2933180
21/03/2021,Gujarat,3756195,209567,3140047,616148,3140047
22/03/2021,Gujarat,3931630,175435,3308984,622646,3308984
23/03/2021,Gujarat,4201102,269472,3571094,630008,3571094
24/03/2021,Gujarat,4381443,180341,3746626,634817,3746626
25/03/2021,Gujarat,4618906,237463,3979710,639196,3979710
26/03/2021,Gujarat,4861329,242423,4217590,643739,4217590
27/03/2021,Gujarat,5116383,255054,4469272,647111,4469272
28/03/2021,Gujarat,5207119,90736,4559341,647778,4559341
29/03/2021,Gujarat,5225227,18108,4576803,648424,4576803
30/03/2021,Gujarat,5438943,213716,4769080,669863,4769080
31/03/2021,Gujarat,5655568,216625,4961044,694524,4961044
01/04/2021,Gujarat,5937684,282116,5220204,717480,5220204
02/04/2021,Gujarat,6454155,516471,5696407,757748,5696407
03/04/2021,Gujarat,6838585,384430,6049037,789548,6049037
04/04/2021,Gujarat,7313218,474633,6481838,831380,6481838
05/04/2021,Gujarat,7584968,271750,6722336,862632,6722336
06/04/2021,Gujarat,7787907,202939,6904732,883175,6904732
07/04/2021,Gujarat,8108812,320905,7190429,918383,7190429
08/04/2021,Gujarat,8473351,364539,7499654,973697,7499654
09/04/2021,Gujarat,8772856,299505,7748080,1024776,7748080
10/04/2021,Gujarat,9055878,283022,7982633,1073245,7982633
11/04/2021,Gujarat,9258859,202981,8155231,1103628,8155231
12/04/2021,Gujarat,9497513,238654,8342548,1154965,8342548
13/04/2021,Gujarat,9703358,205845,8501205,1202153,8501205
14/04/2021,Gujarat,9866787,163429,8622576,1244211,8622576
15/04/2021,Gujarat,10026689,159902,8728318,1298371,8728318
16/04/2021,Gujarat,10165300,138611,8814264,1351036,8814264
17/04/2021,Gujarat,10336808,171508,8921355,1415453,8921355
18/04/2021,Gujarat,10450564,113756,8991639,1458925,8991639
19/04/2021,Gujarat,10620128,169564,9083040,1537088,9083040
20/04/2021,Gujarat,10806479,186351,9181042,1625437,9181042
21/04/2021,Gujarat,10937835,131356,9250895,1686940,9250895
22/04/2021,Gujarat,11098076,160241,9328416,1769660,9328416
23/04/2021,Gujarat,11266124,168048,9412213,1853911,9412213
24/04/2021,Gujarat,11436249,170125,9495699,1940550,9495699
25/04/2021,Gujarat,11537861,101612,9549793,1988068,9549793
26/04/2021,Gujarat,11720832,182971,9634190,2086642,9634190
27/04/2021,Gujarat,11901253,180421,9718868,2182385,9718868
28/04/2021,Gujarat,12053881,152628,9787160,2266721,9787160
29/04/2021,Gujarat,12251389,197508,9873924,2377465,9873924
30/04/2021,Gujarat,12457754,206365,9965407,2492347,9965407
01/05/2021,Gujarat,12679389,221635,10092582,2586807,10092582
02/05/2021,Gujarat,12803024,123635,10161231,2641793,10161231
03/05/2021,Gujarat,12966110,163086,10243032,2723078,10243032
04/05/2021,Gujarat,13094157,128047,10330960,2763197,10330960
05/05/2021,Gujarat,13267196,173039,10417828,2849368,10417828
06/05/2021,Gujarat,13473812,206616,10505574,2968238,10505574
07/05/2021,Gujarat,13680484,206672,10593635,3086849,10593635
08/05/2021,Gujarat,13881007,200523,10676626,3204381,10676626
09/05/2021,Gujarat,14036695,155688,10741045,3295650,10741045
10/05/2021,Gujarat,14301060,264365,10840347,3460713,10840347
11/05/2021,Gujarat,14610441,309381,10952235,3658206,10952235
12/05/2021,Gujarat,14767554,157113,11041502,3726052,11041502
13/05/2021,Gujarat,14975803,208249,11145747,3830056,11145747
14/05/2021,Gujarat,15019896,44093,11180770,3839126,11180770
15/05/2021,Gujarat,15055582,35686,11213044,3842538,11213044
16/05/2021,Gujarat,15085762,30180,11243101,3842661,11243101
17/05/2021,Gujarat,15086042,280,11243305,3842737,11243305
18/05/2021,Gujarat,15086347,305,11243561,3842786,11243561
19/05/2021,Gujarat,15087757,1410,11244920,3842837,11244920
20/05/2021,Gujarat,15178758,91001,11322050,3856708,11322050
21/05/2021,Gujarat,15283427,104669,11411002,3872425,11411002
22/05/2021,Gujarat,15409606,126179,11511484,3898122,11511484
23/05/2021,Gujarat,15516777,107171,11596730,3920047,11596730
24/05/2021,Gujarat,15704013,187236,11761248,3942765,11761248
25/05/2021,Gujarat,15900264,196251,11931536,3968728,11931536
26/05/2021,Gujarat,16089270,189006,12096866,3992404,12096866
27/05/2021,Gujarat,16288328,199058,12267948,4020380,12267948
28/05/2021,Gujarat,16506745,218417,12450336,4056409,12450336
29/05/2021,Gujarat,16724256,217511,12634113,4090143,12634113
30/05/2021,Gujarat,16910245,185989,12795634,4114611,12795634
31/05/2021,Gujarat,17110619,200374,12965663,4144956,12965663
01/06/2021,Gujarat,17309564,198945,13131370,4178194,13131370
02/06/2021,Gujarat,17486132,176568,13283712,4202420,13283712
03/06/2021,Gujarat,17665975,179843,13433285,4232690,13433285
04/06/2021,Gujarat,17936071,270096,13674583,4261488,13674583
05/06/2021,Gujarat,18201215,265144,13915183,4286032,13915183
06/06/2021,Gujarat,18427691,226476,14128072,4299619,14128072
07/06/2021,Gujarat,18686516,258825,14359541,4326975,14359541
08/06/2021,Gujarat,18949901,263385,14587473,4362428,14587473
09/06/2021,Gujarat,19203211,253310,14801548,4401663,14801548
10/06/2021,Gujarat,19478852,275641,15022634,4456218,15022634
11/06/2021,Gujarat,19769106,290254,15262470,4506636,15262470
12/06/2021,Gujarat,20068185,299079,15522137,4546048,15522137
13/06/2021,Gujarat,20303072,234887,15729860,4573212,15729860
14/06/2021,Gujarat,20587151,284079,15979244,4607907,15979244
15/06/2021,Gujarat,20855692,268541,16214004,4641688,16214004
16/06/2021,Gujarat,21112010,256318,16440786,4671224,16440786
17/06/2021,Gujarat,21334287,222277,16632294,4701993,16632294
18/06/2021,Gujarat,21596263,261976,16854511,4741752,16854511
19/06/2021,Gujarat,21903561,307298,17116300,4787261,17116300
20/06/2021,Gujarat,22099535,195974,17278756,4820779,17278756
21/06/2021,Gujarat,22619651,520116,17730463,4889188,17730463
22/06/2021,Gujarat,23067276,447625,18105136,4962140,18105136
23/06/2021,Gujarat,23513610,446334,18475269,5038341,18475269
24/06/2021,Gujarat,23968923,455313,18826982,5141941,18826982
25/06/2021,Gujarat,24271144,302221,19053252,5217892,
26/06/2021,Gujarat,24657300,386156,19330981,5326319,
27/06/2021,Gujarat,24887523,230223,19500271,5387252,
28/06/2021,Gujarat,25141162,253639,19683467,5457695,
29/06/2021,Gujarat,25408616,267454,19872911,5535705,
30/06/2021,Gujarat,25692042,283426,20070872,5621170,
01/07/2021,Gujarat,25973769,281727,20266271,5707498,
02/07/2021,Gujarat,26219791,246022,20427199,5792592,
03/07/2021,Gujarat,26552791,333000,20653026,5899765,
04/07/2021,Gujarat,26815799,263008,20835546,5980253,
05/07/2021,Gujarat,27118289,302490,21037286,6081003,
06/07/2021,Gujarat,27331752,213463,21181190,6150562,
07/07/2021,Gujarat,27340027,8275,21186487,6153540,
08/07/2021,Gujarat,27347053,7026,21189977,6157076,
09/07/2021,Gujarat,27353299,6246,21193413,6159886,
10/07/2021,Gujarat,27637054,283755,21372920,6264134,
11/07/2021,Gujarat,27866090,229036,21524473,6341617,
12/07/2021,Gujarat,28122889,256799,21694463,6428426,
13/07/2021,Gujarat,28376312,253423,21860758,6515554,
14/07/2021,Gujarat,28503866,127554,21984688,6519178,
15/07/2021,Gujarat,28762393,258527,22155836,6606557,
16/07/2021,Gujarat,29037045,274652,22342001,6695044,
17/07/2021,Gujarat,29350855,313810,22562358,6788497,
18/07/2021,Gujarat,29354675,3820,22564829,6789846,
19/07/2021,Gujarat,29751152,396477,22849133,6902019,
20/07/2021,Gujarat,30164637,413485,23145112,7019525,
21/07/2021,Gujarat,30174789,10152,23152218,7022571,
22/07/2021,Gujarat,30682161,507372,23508914,7173247,
23/07/2021,Gujarat,31024303,342142,23751722,7272581,
24/07/2021,Gujarat,31316732,292429,23953275,7363457,
25/07/2021,Gujarat,31639048,322316,24207744,7431304,
26/07/2021,Gujarat,31813064,174016,24295191,7517873,
27/07/2021,Gujarat,32188899,375835,24554163,7634736,
28/07/2021,Gujarat,32203120,14221,24563776,7639344,
29/07/2021,Gujarat,32635472,432352,24873108,7762364,
30/07/2021,Gujarat,32988155,352683,25138838,7849317,
31/07/2021,Gujarat,33278880,290725,25341390,7937490,
01/08/2021,Gujarat,33738204,459324,25455648,8282556,
02/08/2021,Gujarat,34092852,354648,25735670,8357182,
03/08/2021,Gujarat,34430870,338018,25999229,8431641,
04/08/2021,Gujarat,34445808,14938,26008632,8437176,
05/08/2021,Gujarat,35013810,568002,26465196,8548614,
06/08/2021,Gujarat,35630296,616486,26978214,8652082,
07/08/2021,Gujarat,36211785,581489,27460899,8750886,
08/08/2021,Gujarat,36596532,384747,27636206,8960326,
09/08/2021,Gujarat,37152375,555843,28101222,9051153,
,,,,,,
,,,,,,
,,,,,,
,,,,,,
,,,,,,
,,,,,,
16/01/2021,Haryana,1864,1864,1864,0,1864
17/01/2021,Haryana,2069,205,2069,0,2069
18/01/2021,Haryana,5360,3291,5360,0,5360
19/01/2021,Haryana,11728,6368,11728,0,11728
20/01/2021,Haryana,12354,626,12354,0,12354
21/01/2021,Haryana,21411,9057,21411,0,21411
22/01/2021,Haryana,33730,12319,33730,0,33730
23/01/2021,Haryana,43350,9620,43350,0,43350
24/01/2021,Haryana,44934,1584,44934,0,44934
25/01/2021,Haryana,72277,27343,72277,0,72277
26/01/2021,Haryana,72583,306,72583,0,72583
27/01/2021,Haryana,80541,7958,80541,0,80541
28/01/2021,Haryana,87153,6612,87153,0,87153
29/01/2021,Haryana,92685,5532,92685,0,92685
30/01/2021,Haryana,95143,2458,95143,0,95143
31/01/2021,Haryana,95245,102,95245,0,95245
01/02/2021,Haryana,96304,1059,96304,0,96304
02/02/2021,Haryana,97213,909,97213,0,97213
03/02/2021,Haryana,99192,1979,99192,0,99192
04/02/2021,Haryana,103334,4142,103334,0,103334
05/02/2021,Haryana,107280,3946,107280,0,107280
06/02/2021,Haryana,108966,1686,108966,0,108966
07/02/2021,Haryana,110591,1625,110591,0,110591
08/02/2021,Haryana,140415,29824,140415,0,140415
09/02/2021,Haryana,157055,16640,157055,0,157055
10/02/2021,Haryana,164151,7096,164151,0,164151
11/02/2021,Haryana,171926,7775,171926,0,171926
12/02/2021,Haryana,176310,4384,176310,0,176310
13/02/2021,Haryana,178657,2347,178067,590,178067
14/02/2021,Haryana,178664,7,178074,590,178074
15/02/2021,Haryana,188482,9818,185578,2904,185578
16/02/2021,Haryana,190197,1715,186539,3658,186539
17/02/2021,Haryana,195563,5366,189505,6058,189505
18/02/2021,Haryana,206032,10469,193238,12794,193238
19/02/2021,Haryana,218170,12138,201383,16787,201383
20/02/2021,Haryana,223857,5687,204604,19253,204604
21/02/2021,Haryana,224225,368,204756,19469,204756
22/02/2021,Haryana,244791,20566,209690,35101,209690
23/02/2021,Haryana,257756,12965,212356,45400,212356
24/02/2021,Haryana,260336,2580,213246,47090,213246
25/02/2021,Haryana,275940,15604,217574,58366,217574
26/02/2021,Haryana,280173,4233,218507,61666,218507
27/02/2021,Haryana,280175,2,218509,61666,218509
28/02/2021,Haryana,280181,6,218515,61666,218515
01/03/2021,Haryana,280181,0,218515,61666,218515
02/03/2021,Haryana,290716,10535,225787,64929,225787
03/03/2021,Haryana,295902,5186,229802,66100,229802
04/03/2021,Haryana,311564,15662,241858,69706,241858
05/03/2021,Haryana,327198,15634,254547,72651,254547
06/03/2021,Haryana,336481,9283,262058,74423,262058
07/03/2021,Haryana,337525,1044,263037,74488,263037
08/03/2021,Haryana,365090,27565,285193,79897,285193
09/03/2021,Haryana,319081,-46009,230790,88291,319081
10/03/2021,Haryana,331094,12013,239333,91761,331094
11/03/2021,Haryana,339893,8799,246074,93819,339893
12/03/2021,Haryana,376401,36508,275854,100547,376401
13/03/2021,Haryana,392137,15736,289284,102853,392137
14/03/2021,Haryana,395967,3830,292773,103194,395967
15/03/2021,Haryana,515583,119616,403081,112502,515583
16/03/2021,Haryana,678896,163313,561120,117776,561120
17/03/2021,Haryana,748352,69456,627943,120409,627943
18/03/2021,Haryana,818792,70440,694688,124104,694688
19/03/2021,Haryana,883097,64305,755578,127519,755578
20/03/2021,Haryana,908710,25613,779704,129006,779704
21/03/2021,Haryana,915108,6398,785932,129176,785932
22/03/2021,Haryana,1064213,149105,930026,134187,930026
23/03/2021,Haryana,1152753,88540,1016305,136448,1016305
24/03/2021,Haryana,1172883,20130,1035137,137746,1035137
25/03/2021,Haryana,1227860,54977,1087408,140452,1087408
26/03/2021,Haryana,1279258,51398,1136611,142647,1136611
27/03/2021,Haryana,1302499,23241,1158970,143529,1158970
28/03/2021,Haryana,1305966,3467,1162379,143587,1162379
29/03/2021,Haryana,1306530,564,1162932,143598,1162932
30/03/2021,Haryana,1425730,119200,1278501,147229,1278501
31/03/2021,Haryana,1516855,91125,1366981,149874,1366981
01/04/2021,Haryana,1594582,77727,1441284,153298,1441284
02/04/2021,Haryana,1702590,108008,1545216,157374,1545216
03/04/2021,Haryana,1753953,51363,1594393,159560,1594393
04/04/2021,Haryana,1800611,46658,1639535,161076,1639535
05/04/2021,Haryana,1882164,81553,1717234,164930,1717234
06/04/2021,Haryana,1942196,60032,1774869,167327,1774869
07/04/2021,Haryana,2028171,85975,1855846,172325,1855846
08/04/2021,Haryana,2118410,90239,1939723,178687,1939723
09/04/2021,Haryana,2212252,93842,2024825,187427,2024825
10/04/2021,Haryana,2283262,71010,2088650,194612,2088650
11/04/2021,Haryana,2382114,98852,2181488,200626,2181488
12/04/2021,Haryana,2525834,143720,2307539,218295,2307539
13/04/2021,Haryana,2657270,131436,2421185,236085,2421185
14/04/2021,Haryana,2804984,147714,2544240,260744,2544240
15/04/2021,Haryana,2873554,68570,2596134,277420,2596134
16/04/2021,Haryana,2957111,83557,2657655,299456,2657655
17/04/2021,Haryana,3022626,65515,2706244,316382,2706244
18/04/2021,Haryana,3065865,43239,2740333,325532,2740333
19/04/2021,Haryana,3162209,96344,2804924,357285,2804924
20/04/2021,Haryana,3241332,79123,2858633,382699,2858633
21/04/2021,Haryana,3287414,46082,2890194,397220,2890194
22/04/2021,Haryana,3344006,56592,2928139,415867,2928139
23/04/2021,Haryana,3429738,85732,2983811,445927,2983811
24/04/2021,Haryana,3502761,73023,3032220,470541,3032220
25/04/2021,Haryana,3539875,37114,3059704,480171,3059704
26/04/2021,Haryana,3595069,55194,3096107,498962,3096107
27/04/2021,Haryana,3634905,39836,3122680,512225,3122680
28/04/2021,Haryana,3675837,40932,3147907,527930,3147907
29/04/2021,Haryana,3723444,47607,3177552,545892,3177552
30/04/2021,Haryana,3758377,34933,3199035,559342,3199035
01/05/2021,Haryana,3776747,18370,3211614,565133,3211614
02/05/2021,Haryana,3796956,20209,3230331,566625,3230331
03/05/2021,Haryana,3855063,58107,3279593,575470,3279593
04/05/2021,Haryana,3926299,71236,3335067,591232,3335067
05/05/2021,Haryana,3987098,60799,3374963,612135,3374963
06/05/2021,Haryana,4094206,107108,3447474,646732,3447474
07/05/2021,Haryana,4204923,110717,3518724,686199,3518724
08/05/2021,Haryana,4288127,83204,3573590,714537,3573590
09/05/2021,Haryana,4344758,56631,3612642,732116,3612642
10/05/2021,Haryana,4475905,131147,3692472,783433,3692472
11/05/2021,Haryana,4590300,114395,3764214,826086,3764214
12/05/2021,Haryana,4663197,72897,3817367,845830,3817367
13/05/2021,Haryana,4765647,102450,3886385,879262,3886385
14/05/2021,Haryana,4833697,68050,3931468,902229,3931468
15/05/2021,Haryana,4893748,60051,3977395,916353,3977395
16/05/2021,Haryana,4937347,43599,4019157,918190,4019157
17/05/2021,Haryana,5000446,63099,4079084,921362,4079084
18/05/2021,Haryana,5065275,64829,4140970,924305,4140970
19/05/2021,Haryana,5118705,53430,4191994,926711,4191994
20/05/2021,Haryana,5198818,80113,4267171,931647,4267171
21/05/2021,Haryana,5285927,87109,4347426,938501,4347426
22/05/2021,Haryana,5357671,71744,4411857,945814,4411857
23/05/2021,Haryana,5391895,34224,4440936,950959,4440936
24/05/2021,Haryana,5488324,96429,4532709,955615,4532709
25/05/2021,Haryana,5559015,70691,4597932,961083,4597932
26/05/2021,Haryana,5611913,52898,4646721,965192,4646721
27/05/2021,Haryana,5687063,75150,4713609,973454,4713609
28/05/2021,Haryana,5750543,63480,4770088,980455,4770088
29/05/2021,Haryana,5804788,54245,4816451,988337,4816451
30/05/2021,Haryana,5832328,27540,4841864,990464,4841864
31/05/2021,Haryana,5889201,56873,4893257,995944,4893257
01/06/2021,Haryana,5956635,67434,4955133,1001502,4955133
02/06/2021,Haryana,6029937,73302,5025000,1004937,5025000
03/06/2021,Haryana,6104370,74433,5094715,1009655,5094715
04/06/2021,Haryana,6166025,61655,5151851,1014174,5151851
05/06/2021,Haryana,6224238,58213,5205904,1018334,5205904
06/06/2021,Haryana,6246721,22483,5226504,1020217,5226504
07/06/2021,Haryana,6302108,55387,5276368,1025740,5276368
08/06/2021,Haryana,6350659,48551,5319508,1031151,5319508
09/06/2021,Haryana,6433899,83240,5398348,1035551,5398348
10/06/2021,Haryana,6559087,125188,5514458,1044629,5514458
11/06/2021,Haryana,6664080,104993,5608575,1055505,5608575
12/06/2021,Haryana,6749944,85864,5686944,1063000,5686944
13/06/2021,Haryana,6784770,34826,5718756,1066014,5718756
14/06/2021,Haryana,6875456,90686,5797875,1077581,5797875
15/06/2021,Haryana,6952038,76582,5862113,1089925,5862113
16/06/2021,Haryana,7020156,68118,5919214,1100942,5919214
17/06/2021,Haryana,7150855,130699,6031899,1118956,6031899
18/06/2021,Haryana,7247474,96619,6113489,1133985,6113489
19/06/2021,Haryana,7327041,79567,6180911,1146130,6180911
20/06/2021,Haryana,7367943,40902,6216032,1151911,6216032
21/06/2021,Haryana,7879825,511882,6690650,1189175,6690650
22/06/2021,Haryana,8011052,131227,6800712,1210340,6800712
23/06/2021,Haryana,8088643,77591,6863194,1225449,6863194
24/06/2021,Haryana,8168749,80106,6928225,1240524,6928225
25/06/2021,Haryana,8314915,146166,7043353,1271562,
26/06/2021,Haryana,8430740,115825,7132701,1298039,
27/06/2021,Haryana,8473361,42621,7166083,1307278,
28/06/2021,Haryana,8616321,142960,7268600,1347721,
29/06/2021,Haryana,8754231,137910,7365625,1388606,
30/06/2021,Haryana,8856678,102447,7433613,1423065,
01/07/2021,Haryana,9052429,195751,7584644,1467785,
02/07/2021,Haryana,9220204,167775,7705597,1514607,
03/07/2021,Haryana,9360295,140091,7805669,1554626,
04/07/2021,Haryana,9409759,49464,7840063,1569696,
05/07/2021,Haryana,9515937,106178,7907719,1608218,
06/07/2021,Haryana,9581886,65949,7948436,1633450,
07/07/2021,Haryana,9617391,35505,7967878,1649513,
08/07/2021,Haryana,9658310,40919,7991006,1667304,
09/07/2021,Haryana,9768115,109805,8055066,1713049,
10/07/2021,Haryana,9848083,79968,8104736,1743347,
11/07/2021,Haryana,9878706,30623,8123738,1754968,
12/07/2021,Haryana,9930266,51560,8153273,1776993,
13/07/2021,Haryana,10063614,133348,8228952,1834662,
14/07/2021,Haryana,10187224,123610,8323935,1863289,
15/07/2021,Haryana,10258746,71522,8367171,1891575,
16/07/2021,Haryana,10412492,153746,8456784,1955708,
17/07/2021,Haryana,10509222,96730,8514017,1995205,
18/07/2021,Haryana,10578419,69197,8558860,2019559,
19/07/2021,Haryana,10696109,117690,8633271,2062838,
20/07/2021,Haryana,10792955,96846,8692323,2100632,
21/07/2021,Haryana,10827853,34898,8709605,2118248,
22/07/2021,Haryana,10897886,70033,8744222,2153664,
23/07/2021,Haryana,10941640,43754,8769732,2171908,
24/07/2021,Haryana,10982631,40991,8795354,2187277,
25/07/2021,Haryana,11021435,38804,8818842,2202593,
26/07/2021,Haryana,11125623,104188,8880653,2244970,
27/07/2021,Haryana,11209983,84360,8927366,2282617,
28/07/2021,Haryana,11355899,145916,9022451,2333448,
29/07/2021,Haryana,11527918,172019,9129628,2398290,
30/07/2021,Haryana,11679834,151916,9224499,2455335,
31/07/2021,Haryana,11824028,144194,9318405,2505623,
01/08/2021,Haryana,11946622,122594,9408863,2537759,
02/08/2021,Haryana,12143863,197241,9541597,2602266,
03/08/2021,Haryana,12319550,175687,9652428,2667122,
04/08/2021,Haryana,12433360,113810,9721120,2712240,
05/08/2021,Haryana,12548408,115048,9792908,2755500,
06/08/2021,Haryana,12654430,106022,9866470,2787960,
07/08/2021,Haryana,12794804,140374,9952321,2842483,
08/08/2021,Haryana,12871025,76221,10000236,2870789,
09/08/2021,Haryana,13010381,139356,10086831,2923550,
,,,,,,
,,,,,,
,,,,,,
,,,,,,
,,,,,,
,,,,,,
16/01/2021,Himachal Pradesh,202,202,202,0,202
17/01/2021,Himachal Pradesh,202,0,202,0,202
18/01/2021,Himachal Pradesh,352,150,352,0,352
19/01/2021,Himachal Pradesh,448,96,448,0,448
20/01/2021,Himachal Pradesh,448,0,448,0,448
21/01/2021,Himachal Pradesh,610,162,610,0,610
22/01/2021,Himachal Pradesh,1427,817,1427,0,1427
23/01/2021,Himachal Pradesh,5396,3969,5396,0,5396
24/01/2021,Himachal Pradesh,5594,198,5594,0,5594
25/01/2021,Himachal Pradesh,6104,510,6104,0,6104
26/01/2021,Himachal Pradesh,6188,84,6188,0,6188
27/01/2021,Himachal Pradesh,8859,2671,8859,0,8859
28/01/2021,Himachal Pradesh,13883,5024,13883,0,13883
29/01/2021,Himachal Pradesh,17978,4095,17978,0,17978
30/01/2021,Himachal Pradesh,22787,4809,22787,0,22787
31/01/2021,Himachal Pradesh,22798,11,22798,0,22798
01/02/2021,Himachal Pradesh,28464,5666,28464,0,28464
02/02/2021,Himachal Pradesh,34218,5754,34218,0,34218
03/02/2021,Himachal Pradesh,38734,4516,38734,0,38734
04/02/2021,Himachal Pradesh,43053,4319,43053,0,43053
05/02/2021,Himachal Pradesh,46401,3348,46401,0,46401
06/02/2021,Himachal Pradesh,49335,2934,49335,0,49335
07/02/2021,Himachal Pradesh,49338,3,49338,0,49338
08/02/2021,Himachal Pradesh,52715,3377,52715,0,52715
09/02/2021,Himachal Pradesh,56021,3306,56021,0,56021
10/02/2021,Himachal Pradesh,60848,4827,60848,0,60848
11/02/2021,Himachal Pradesh,66825,5977,66825,0,66825
12/02/2021,Himachal Pradesh,73945,7120,73945,0,73945
13/02/2021,Himachal Pradesh,77192,3247,76743,449,76743
14/02/2021,Himachal Pradesh,77192,0,76743,449,76743
15/02/2021,Himachal Pradesh,80952,3760,79084,1868,79084
16/02/2021,Himachal Pradesh,84718,3766,81911,2807,81911
17/02/2021,Himachal Pradesh,90616,5898,86419,4197,86419
18/02/2021,Himachal Pradesh,88620,-1996,83703,4917,83703
19/02/2021,Himachal Pradesh,100648,12028,92440,8208,92440
20/02/2021,Himachal Pradesh,106400,5752,94569,11831,94569
21/02/2021,Himachal Pradesh,106629,229,94796,11833,94796
22/02/2021,Himachal Pradesh,108120,1491,96044,12076,96044
23/02/2021,Himachal Pradesh,109590,1470,97252,12338,97252
24/02/2021,Himachal Pradesh,110920,1330,98414,12506,98414
25/02/2021,Himachal Pradesh,116818,5898,100164,16654,100164
26/02/2021,Himachal Pradesh,121420,4602,100927,20493,100927
27/02/2021,Himachal Pradesh,121420,0,100927,20493,100927
28/02/2021,Himachal Pradesh,121420,0,100927,20493,100927
01/03/2021,Himachal Pradesh,121420,0,100927,20493,100927
02/03/2021,Himachal Pradesh,132714,11294,104128,28586,104128
03/03/2021,Himachal Pradesh,139479,6765,106220,33259,106220
04/03/2021,Himachal Pradesh,148541,9062,110116,38425,110116
05/03/2021,Himachal Pradesh,158469,9928,116257,42212,116257
06/03/2021,Himachal Pradesh,165915,7446,120892,45023,120892
07/03/2021,Himachal Pradesh,168003,2088,122797,45206,122797
08/03/2021,Himachal Pradesh,176202,8199,128118,48084,128118
09/03/2021,Himachal Pradesh,146888,-29314,95370,51518,146888
10/03/2021,Himachal Pradesh,156463,9575,101716,54747,156463
11/03/2021,Himachal Pradesh,157123,660,102129,54994,157123
12/03/2021,Himachal Pradesh,175442,18319,114206,61236,175442
13/03/2021,Himachal Pradesh,182060,6618,118806,63254,182060
14/03/2021,Himachal Pradesh,183378,1318,119986,63392,183378
15/03/2021,Himachal Pradesh,195010,11632,128508,66502,195010
16/03/2021,Himachal Pradesh,273299,78289,203011,70288,203011
17/03/2021,Himachal Pradesh,308812,35513,236523,72289,236523
18/03/2021,Himachal Pradesh,337481,28669,262915,74566,262915
19/03/2021,Himachal Pradesh,358451,20970,281109,77342,281109
20/03/2021,Himachal Pradesh,369805,11354,290409,79396,290409
21/03/2021,Himachal Pradesh,371574,1769,292027,79547,292027
22/03/2021,Himachal Pradesh,381047,9473,300139,80908,300139
23/03/2021,Himachal Pradesh,404158,23111,321471,82687,321471
24/03/2021,Himachal Pradesh,416718,12560,333002,83716,333002
25/03/2021,Himachal Pradesh,455004,38286,370260,84744,370260
26/03/2021,Himachal Pradesh,476805,21801,390817,85988,390817
27/03/2021,Himachal Pradesh,496972,20167,410497,86475,410497
28/03/2021,Himachal Pradesh,498085,1113,411591,86494,411591
29/03/2021,Himachal Pradesh,498916,831,412400,86516,412400
30/03/2021,Himachal Pradesh,527330,28414,439684,87646,439684
31/03/2021,Himachal Pradesh,536465,9135,448077,88388,448077
01/04/2021,Himachal Pradesh,574177,37712,484952,89225,484952
02/04/2021,Himachal Pradesh,594644,20467,504793,89851,504793
03/04/2021,Himachal Pradesh,611300,16656,520521,90779,520521
04/04/2021,Himachal Pradesh,631189,19889,539485,91704,539485
05/04/2021,Himachal Pradesh,661559,30370,568597,92962,568597
06/04/2021,Himachal Pradesh,688362,26803,594144,94218,594144
07/04/2021,Himachal Pradesh,775168,86806,677374,97794,677374
08/04/2021,Himachal Pradesh,841809,66641,741610,100199,741610
09/04/2021,Himachal Pradesh,891279,49470,788372,102907,788372
10/04/2021,Himachal Pradesh,942833,51554,837398,105435,837398
11/04/2021,Himachal Pradesh,983912,41079,876538,107374,876538
12/04/2021,Himachal Pradesh,1051220,67308,940171,111049,940171
13/04/2021,Himachal Pradesh,1111863,60643,996913,114950,996913
14/04/2021,Himachal Pradesh,1157878,46015,1039677,118201,1039677
15/04/2021,Himachal Pradesh,1192530,34652,1070578,121952,1070578
16/04/2021,Himachal Pradesh,1241591,49061,1112736,128855,1112736
17/04/2021,Himachal Pradesh,1278093,36502,1143738,134355,1143738
18/04/2021,Himachal Pradesh,1289502,11409,1153059,136443,1153059
19/04/2021,Himachal Pradesh,1328660,39158,1184950,143710,1184950
20/04/2021,Himachal Pradesh,1378690,50030,1225885,152805,1225885
21/04/2021,Himachal Pradesh,1400800,22110,1244615,156185,1244615
22/04/2021,Himachal Pradesh,1451402,50602,1286057,165345,1286057
23/04/2021,Himachal Pradesh,1497988,46586,1322767,175221,1322767
24/04/2021,Himachal Pradesh,1537559,39571,1354936,182623,1354936
25/04/2021,Himachal Pradesh,1548508,10949,1363273,185235,1363273
26/04/2021,Himachal Pradesh,1593350,44842,1396626,196724,1396626
27/04/2021,Himachal Pradesh,1644453,51103,1434382,210071,1434382
28/04/2021,Himachal Pradesh,1689867,45414,1468126,221741,1468126
29/04/2021,Himachal Pradesh,1743174,53307,1505397,237777,1505397
30/04/2021,Himachal Pradesh,1793341,50167,1541255,252086,1541255
01/05/2021,Himachal Pradesh,1823400,30059,1562272,261128,1562272
02/05/2021,Himachal Pradesh,1828966,5566,1566274,262692,1566274
03/05/2021,Himachal Pradesh,1874042,45076,1595354,278688,1595354
04/05/2021,Himachal Pradesh,1920953,46911,1624444,296509,1624444
05/05/2021,Himachal Pradesh,1956253,35300,1645491,310762,1645491
06/05/2021,Himachal Pradesh,2005160,48907,1671620,333540,1671620
07/05/2021,Himachal Pradesh,2037602,32442,1688202,349400,1688202
08/05/2021,Himachal Pradesh,2058866,21264,1699206,359660,1699206
09/05/2021,Himachal Pradesh,2065283,6417,1702305,362978,1702305
10/05/2021,Himachal Pradesh,2097748,32465,1717794,379954,1717794
11/05/2021,Himachal Pradesh,2125140,27392,1730336,394804,1730336
12/05/2021,Himachal Pradesh,2141989,16849,1740172,401817,1740172
13/05/2021,Himachal Pradesh,2175417,33428,1757908,417509,1757908
14/05/2021,Himachal Pradesh,2191401,15984,1767255,424146,1767255
15/05/2021,Himachal Pradesh,2217221,25820,1784546,432675,1784546
16/05/2021,Himachal Pradesh,2220769,3548,1787942,432827,1787942
17/05/2021,Himachal Pradesh,2243890,23121,1810997,432893,1810997
18/05/2021,Himachal Pradesh,2265500,21610,1832502,432998,1832502
19/05/2021,Himachal Pradesh,2281222,15722,1848161,433061,1848161
20/05/2021,Himachal Pradesh,2304113,22891,1871031,433082,1871031
21/05/2021,Himachal Pradesh,2323018,18905,1889841,433177,1889841
22/05/2021,Himachal Pradesh,2334587,11569,1901360,433227,1901360
23/05/2021,Himachal Pradesh,2336772,2185,1903533,433239,1903533
24/05/2021,Himachal Pradesh,2358357,21585,1925091,433266,1925091
25/05/2021,Himachal Pradesh,2377021,18664,1943657,433364,1943657
26/05/2021,Himachal Pradesh,2383941,6920,1950536,433405,1950536
27/05/2021,Himachal Pradesh,2405467,21526,1972047,433420,1972047
28/05/2021,Himachal Pradesh,2419143,13676,1985601,433542,1985601
29/05/2021,Himachal Pradesh,2429862,10719,1996254,433608,1996254
30/05/2021,Himachal Pradesh,2431191,1329,1997579,433612,1997579
31/05/2021,Himachal Pradesh,2456257,25066,2022636,433621,2022636
01/06/2021,Himachal Pradesh,2471148,14891,2037384,433764,2037384
02/06/2021,Himachal Pradesh,2482794,11646,2048963,433831,2048963
03/06/2021,Himachal Pradesh,2494074,11280,2060164,433910,2060164
04/06/2021,Himachal Pradesh,2509695,15621,2075616,434079,2075616
05/06/2021,Himachal Pradesh,2523243,13548,2089053,434190,2089053
06/06/2021,Himachal Pradesh,2524493,1250,2090289,434204,2090289
07/06/2021,Himachal Pradesh,2536559,12066,2102102,434457,2102102
08/06/2021,Himachal Pradesh,2549426,12867,2114649,434777,2114649
09/06/2021,Himachal Pradesh,2557978,8552,2123031,434947,2123031
10/06/2021,Himachal Pradesh,2566399,8421,2131119,435280,2131119
11/06/2021,Himachal Pradesh,2576674,10275,2141030,435644,2141030
12/06/2021,Himachal Pradesh,2587927,11253,2151953,435974,2151953
13/06/2021,Himachal Pradesh,2588086,159,2152111,435975,2152111
14/06/2021,Himachal Pradesh,2614787,26701,2178801,435986,2178801
15/06/2021,Himachal Pradesh,2659045,44258,2222751,436294,2222751
16/06/2021,Himachal Pradesh,2699523,40478,2262895,436628,2262895
17/06/2021,Himachal Pradesh,2741702,42179,2304599,437103,2304599
18/06/2021,Himachal Pradesh,2793097,51395,2354749,438348,2354749
19/06/2021,Himachal Pradesh,2819145,26048,2378841,440304,2378841
20/06/2021,Himachal Pradesh,2819998,853,2379678,440320,2379678
21/06/2021,Himachal Pradesh,2918724,98726,2478389,440335,2478389
22/06/2021,Himachal Pradesh,3040740,122016,2600380,440360,2600380
23/06/2021,Himachal Pradesh,3185389,144649,2744942,440447,2744942
24/06/2021,Himachal Pradesh,3223393,38004,2773268,450125,2773268
25/06/2021,Himachal Pradesh,3330049,106656,2868066,461983,
26/06/2021,Himachal Pradesh,3482066,152017,3010202,471864,
27/06/2021,Himachal Pradesh,3497784,15718,3025895,471889,
28/06/2021,Himachal Pradesh,3666915,169131,3187698,479217,
29/06/2021,Himachal Pradesh,3827079,160164,3338511,488568,
30/06/2021,Himachal Pradesh,3866287,39208,3351501,514786,
01/07/2021,Himachal Pradesh,3908924,42637,3362065,546859,
02/07/2021,Himachal Pradesh,3947386,38462,3370592,576794,
03/07/2021,Himachal Pradesh,3985889,38503,3378237,607652,
04/07/2021,Himachal Pradesh,3986005,116,3378319,607686,
05/07/2021,Himachal Pradesh,4047093,61088,3387795,659298,
06/07/2021,Himachal Pradesh,4115822,68729,3398020,717802,
07/07/2021,Himachal Pradesh,4173028,57206,3406867,766161,
08/07/2021,Himachal Pradesh,4220136,47108,3414079,806057,
09/07/2021,Himachal Pradesh,4258863,38727,3419934,838929,
10/07/2021,Himachal Pradesh,4281031,22168,3423175,857856,
11/07/2021,Himachal Pradesh,4281308,277,3423246,858062,
12/07/2021,Himachal Pradesh,4319288,37980,3427554,891734,
13/07/2021,Himachal Pradesh,4361944,42656,3433064,928880,
14/07/2021,Himachal Pradesh,4447275,85331,3491953,955322,
15/07/2021,Himachal Pradesh,4473681,26406,3495554,978127,
16/07/2021,Himachal Pradesh,4500778,27097,3498848,1001930,
17/07/2021,Himachal Pradesh,4544791,44013,3505004,1039787,
18/07/2021,Himachal Pradesh,4544883,92,3505080,1039803,
19/07/2021,Himachal Pradesh,4607739,62856,3542306,1065433,
20/07/2021,Himachal Pradesh,4683571,75832,3593645,1089926,
21/07/2021,Himachal Pradesh,4684058,487,3594024,1090034,
22/07/2021,Himachal Pradesh,4762348,78290,3645454,1116894,
23/07/2021,Himachal Pradesh,4841256,78908,3697711,1143545,
24/07/2021,Himachal Pradesh,4907673,66417,3740883,1166790,
25/07/2021,Himachal Pradesh,4907764,91,3740953,1166811,
26/07/2021,Himachal Pradesh,4965278,57514,3779130,1186148,
27/07/2021,Himachal Pradesh,5020337,55059,3813969,1206368,
28/07/2021,Himachal Pradesh,5067025,46688,3844633,1222392,
29/07/2021,Himachal Pradesh,5096580,29555,3863935,1232645,
30/07/2021,Himachal Pradesh,5149148,52568,3898160,1250988,
31/07/2021,Himachal Pradesh,5222691,73543,3949268,1273423,
01/08/2021,Himachal Pradesh,5242244,19553,3968690,1273554,
02/08/2021,Himachal Pradesh,5301613,59369,4010075,1291538,
03/08/2021,Himachal Pradesh,5356516,54903,4048893,1307623,
04/08/2021,Himachal Pradesh,5405528,49012,4083812,1321716,
05/08/2021,Himachal Pradesh,5449747,44219,4115577,1334170,
06/08/2021,Himachal Pradesh,5502831,53084,4155025,1347806,
07/08/2021,Himachal Pradesh,5551177,48346,4190219,1360958,
08/08/2021,Himachal Pradesh,5551548,371,4190561,1360987,
09/08/2021,Himachal Pradesh,5632441,80893,4249849,1382592,
,,,,,,
,,,,,,
,,,,,,
,,,,,,
,,,,,,
,,,,,,
16/01/2021,Jammu and Kashmir,377,377,377,0,377
17/01/2021,Jammu and Kashmir,421,44,421,0,421
18/01/2021,Jammu and Kashmir,672,251,672,0,672
19/01/2021,Jammu and Kashmir,1369,697,1369,0,1369
20/01/2021,Jammu and Kashmir,1369,0,1369,0,1369
21/01/2021,Jammu and Kashmir,2296,927,2296,0,2296
22/01/2021,Jammu and Kashmir,3807,1511,3807,0,3807
23/01/2021,Jammu and Kashmir,5593,1786,5593,0,5593
24/01/2021,Jammu and Kashmir,5893,300,5893,0,5893
25/01/2021,Jammu and Kashmir,10498,4605,10498,0,10498
26/01/2021,Jammu and Kashmir,10626,128,10626,0,10626
27/01/2021,Jammu and Kashmir,11562,936,11562,0,11562
28/01/2021,Jammu and Kashmir,17280,5718,17280,0,17280
29/01/2021,Jammu and Kashmir,21124,3844,21124,0,21124
30/01/2021,Jammu and Kashmir,21261,137,21261,0,21261
31/01/2021,Jammu and Kashmir,21268,7,21268,0,21268
01/02/2021,Jammu and Kashmir,21322,54,21322,0,21322
02/02/2021,Jammu and Kashmir,21352,30,21352,0,21352
03/02/2021,Jammu and Kashmir,21478,126,21478,0,21478
04/02/2021,Jammu and Kashmir,27796,6318,27796,0,27796
05/02/2021,Jammu and Kashmir,33899,6103,33899,0,33899
06/02/2021,Jammu and Kashmir,40909,7010,40909,0,40909
07/02/2021,Jammu and Kashmir,41543,634,41543,0,41543
08/02/2021,Jammu and Kashmir,51872,10329,51872,0,51872
09/02/2021,Jammu and Kashmir,63529,11657,63529,0,63529
10/02/2021,Jammu and Kashmir,65779,2250,65779,0,65779
11/02/2021,Jammu and Kashmir,83295,17516,83295,0,83295
12/02/2021,Jammu and Kashmir,100823,17528,100823,0,100823
13/02/2021,Jammu and Kashmir,118399,17576,117677,722,117677
14/02/2021,Jammu and Kashmir,119015,616,118293,722,118293
15/02/2021,Jammu and Kashmir,136032,17017,134369,1663,134369
16/02/2021,Jammu and Kashmir,150271,14239,148004,2267,148004
17/02/2021,Jammu and Kashmir,151145,874,148878,2267,148878
18/02/2021,Jammu and Kashmir,166429,15284,163037,3392,163037
19/02/2021,Jammu and Kashmir,181492,15063,176551,4941,176551
20/02/2021,Jammu and Kashmir,192355,10863,186097,6258,186097
21/02/2021,Jammu and Kashmir,192581,226,186304,6277,186304
22/02/2021,Jammu and Kashmir,204193,11612,195331,8862,195331
23/02/2021,Jammu and Kashmir,212075,7882,202132,9943,202132
24/02/2021,Jammu and Kashmir,212702,627,202749,9953,202749
25/02/2021,Jammu and Kashmir,226087,13385,213201,12886,213201
26/02/2021,Jammu and Kashmir,238073,11986,222386,15687,222386
27/02/2021,Jammu and Kashmir,238073,0,222386,15687,222386
28/02/2021,Jammu and Kashmir,238075,2,222388,15687,222388
01/03/2021,Jammu and Kashmir,238075,0,222388,15687,222388
02/03/2021,Jammu and Kashmir,258723,20648,241454,17269,241454
03/03/2021,Jammu and Kashmir,260977,2254,243610,17367,243610
04/03/2021,Jammu and Kashmir,277184,16207,257976,19208,257976
05/03/2021,Jammu and Kashmir,294559,17375,272803,21756,272803
06/03/2021,Jammu and Kashmir,313949,19390,288844,25105,288844
07/03/2021,Jammu and Kashmir,314237,288,289112,25125,289112
08/03/2021,Jammu and Kashmir,339975,25738,309309,30666,309309
09/03/2021,Jammu and Kashmir,335454,-4521,298325,37129,335454
10/03/2021,Jammu and Kashmir,336723,1269,299275,37448,336723
11/03/2021,Jammu and Kashmir,337836,1113,300120,37716,337836
12/03/2021,Jammu and Kashmir,340719,2883,300849,39870,340719
13/03/2021,Jammu and Kashmir,378291,37572,323433,54858,378291
14/03/2021,Jammu and Kashmir,379043,752,323902,55141,379043
15/03/2021,Jammu and Kashmir,415786,36743,347322,68464,415786
16/03/2021,Jammu and Kashmir,490249,74463,409038,81211,409038
17/03/2021,Jammu and Kashmir,506212,15963,424693,81519,424693
18/03/2021,Jammu and Kashmir,545897,39685,452341,93556,452341
19/03/2021,Jammu and Kashmir,569002,23105,467694,101308,467694
20/03/2021,Jammu and Kashmir,583776,14774,477578,106198,477578
21/03/2021,Jammu and Kashmir,585549,1773,478715,106834,478715
22/03/2021,Jammu and Kashmir,615587,30038,499326,116261,499326
23/03/2021,Jammu and Kashmir,643931,28344,520247,123684,520247
24/03/2021,Jammu and Kashmir,645295,1364,520936,124359,520936
25/03/2021,Jammu and Kashmir,680969,35674,549986,130983,549986
26/03/2021,Jammu and Kashmir,708706,27737,573587,135119,573587
27/03/2021,Jammu and Kashmir,734150,25444,595686,138464,595686
28/03/2021,Jammu and Kashmir,735216,1066,596652,138564,596652
29/03/2021,Jammu and Kashmir,760669,25453,618375,142294,618375
30/03/2021,Jammu and Kashmir,787931,27262,641299,146632,641299
31/03/2021,Jammu and Kashmir,789202,1271,642348,146854,642348
01/04/2021,Jammu and Kashmir,820121,30919,669358,150763,669358
02/04/2021,Jammu and Kashmir,862951,42830,707269,155682,707269
03/04/2021,Jammu and Kashmir,896589,33638,737067,159522,737067
04/04/2021,Jammu and Kashmir,926410,29821,764873,161537,764873
05/04/2021,Jammu and Kashmir,965018,38608,799804,165214,799804
06/04/2021,Jammu and Kashmir,1000073,35055,831857,168216,831857
07/04/2021,Jammu and Kashmir,1083663,83590,909465,174198,909465
08/04/2021,Jammu and Kashmir,1177106,93443,994678,182428,994678
09/04/2021,Jammu and Kashmir,1240399,63293,1053587,186812,1053587
10/04/2021,Jammu and Kashmir,1286329,45930,1095604,190725,1095604
11/04/2021,Jammu and Kashmir,1321714,35385,1128724,192990,1128724
12/04/2021,Jammu and Kashmir,1390071,68357,1190462,199609,1190462
13/04/2021,Jammu and Kashmir,1420580,30509,1217666,202914,1217666
14/04/2021,Jammu and Kashmir,1452639,32059,1245840,206799,1245840
15/04/2021,Jammu and Kashmir,1500140,47501,1285404,214736,1285404
16/04/2021,Jammu and Kashmir,1544416,44276,1322027,222389,1322027
17/04/2021,Jammu and Kashmir,1588988,44572,1358605,230383,1358605
18/04/2021,Jammu and Kashmir,1622097,33109,1386560,235537,1386560
19/04/2021,Jammu and Kashmir,1688073,65976,1439317,248756,1439317
20/04/2021,Jammu and Kashmir,1752949,64876,1492291,260658,1492291
21/04/2021,Jammu and Kashmir,1801163,48214,1532708,268455,1532708
22/04/2021,Jammu and Kashmir,1856450,55287,1576508,279942,1576508
23/04/2021,Jammu and Kashmir,1924526,68076,1632265,292261,1632265
24/04/2021,Jammu and Kashmir,1996721,72195,1691210,305511,1691210
25/04/2021,Jammu and Kashmir,2043208,46487,1731283,311925,1731283
26/04/2021,Jammu and Kashmir,2125643,82435,1798206,327437,1798206
27/04/2021,Jammu and Kashmir,2186894,61251,1848389,338505,1848389
28/04/2021,Jammu and Kashmir,2256066,69172,1904409,351657,1904409
29/04/2021,Jammu and Kashmir,2311019,54953,1946913,364106,1946913
30/04/2021,Jammu and Kashmir,2348049,37030,1974919,373130,1974919
01/05/2021,Jammu and Kashmir,2376239,28190,1995989,380250,1995989
02/05/2021,Jammu and Kashmir,2415072,38833,2027309,387763,2027309
03/05/2021,Jammu and Kashmir,2467470,52398,2065375,402095,2065375
04/05/2021,Jammu and Kashmir,2503624,36154,2091960,411664,2091960
05/05/2021,Jammu and Kashmir,2560453,56829,2133638,426815,2133638
06/05/2021,Jammu and Kashmir,2610901,50448,2166988,443913,2166988
07/05/2021,Jammu and Kashmir,2673010,62109,2208633,464377,2208633
08/05/2021,Jammu and Kashmir,2717486,44476,2236255,481231,2236255
09/05/2021,Jammu and Kashmir,2730327,12841,2244582,485745,2244582
10/05/2021,Jammu and Kashmir,2762379,32052,2261462,500917,2261462
11/05/2021,Jammu and Kashmir,2792754,30375,2277054,515700,2277054
12/05/2021,Jammu and Kashmir,2806013,13259,2286567,519446,2286567
13/05/2021,Jammu and Kashmir,2811983,5970,2290511,521472,2290511
14/05/2021,Jammu and Kashmir,2829044,17061,2301414,527630,2301414
15/05/2021,Jammu and Kashmir,2846293,17249,2313307,532986,2313307
16/05/2021,Jammu and Kashmir,2854854,8561,2321690,533164,2321690
17/05/2021,Jammu and Kashmir,2869473,14619,2335697,533776,2335697
18/05/2021,Jammu and Kashmir,2882672,13199,2348544,534128,2348544
19/05/2021,Jammu and Kashmir,2890348,7676,2356090,534258,2356090
20/05/2021,Jammu and Kashmir,2905453,15105,2370453,535000,2370453
21/05/2021,Jammu and Kashmir,2919082,13629,2383343,535739,2383343
22/05/2021,Jammu and Kashmir,2955597,36515,2418184,537413,2418184
23/05/2021,Jammu and Kashmir,2973265,17668,2435203,538062,2435203
24/05/2021,Jammu and Kashmir,3010300,37035,2470847,539453,2470847
25/05/2021,Jammu and Kashmir,3050427,40127,2510205,540222,2510205
26/05/2021,Jammu and Kashmir,3094817,44390,2554226,540591,2554226
27/05/2021,Jammu and Kashmir,3155082,60265,2613886,541196,2613886
28/05/2021,Jammu and Kashmir,3204395,49313,2662543,541852,2662543
29/05/2021,Jammu and Kashmir,3242705,38310,2699856,542849,2699856
30/05/2021,Jammu and Kashmir,3265442,22737,2722017,543425,2722017
31/05/2021,Jammu and Kashmir,3301002,35560,2754861,546141,2754861
01/06/2021,Jammu and Kashmir,3334213,33211,2784248,549965,2784248
02/06/2021,Jammu and Kashmir,3367582,33369,2813904,553678,2813904
03/06/2021,Jammu and Kashmir,3398622,31040,2841416,557206,2841416
04/06/2021,Jammu and Kashmir,3429944,31322,2868479,561465,2868479
05/06/2021,Jammu and Kashmir,3461430,31486,2896360,565070,2896360
06/06/2021,Jammu and Kashmir,3476138,14708,2910164,565974,2910164
07/06/2021,Jammu and Kashmir,3501829,25691,2932304,569525,2932304
08/06/2021,Jammu and Kashmir,3528456,26627,2955248,573208,2955248
09/06/2021,Jammu and Kashmir,3549785,21329,2974987,574798,2974987
10/06/2021,Jammu and Kashmir,3582621,32836,3005115,577506,3005115
11/06/2021,Jammu and Kashmir,3616809,34188,3036734,580075,3036734
12/06/2021,Jammu and Kashmir,3651569,34760,3068862,582707,3068862
13/06/2021,Jammu and Kashmir,3680941,29372,3097492,583449,3097492
14/06/2021,Jammu and Kashmir,3732404,51463,3146640,585764,3146640
15/06/2021,Jammu and Kashmir,3782472,50068,3194499,587973,3194499
16/06/2021,Jammu and Kashmir,3818944,36472,3229615,589329,3229615
17/06/2021,Jammu and Kashmir,3860287,41343,3267877,592410,3267877
18/06/2021,Jammu and Kashmir,3910835,50548,3313601,597234,3313601
19/06/2021,Jammu and Kashmir,3953717,42882,3351691,602026,3351691
20/06/2021,Jammu and Kashmir,3970723,17006,3367528,603195,3367528
21/06/2021,Jammu and Kashmir,4009211,38488,3402011,607200,3402011
22/06/2021,Jammu and Kashmir,4051418,42207,3439485,611933,3439485
23/06/2021,Jammu and Kashmir,4119122,67704,3502239,616883,3502239
24/06/2021,Jammu and Kashmir,4169680,50558,3546680,623000,3546680
25/06/2021,Jammu and Kashmir,4232071,62391,3602396,629675,
26/06/2021,Jammu and Kashmir,4282658,50587,3643605,639053,
27/06/2021,Jammu and Kashmir,4344943,62285,3699377,645566,
28/06/2021,Jammu and Kashmir,4416417,71474,3758141,658276,
29/06/2021,Jammu and Kashmir,4467382,50965,3801390,665992,
30/06/2021,Jammu and Kashmir,4525535,58153,3844705,680830,
01/07/2021,Jammu and Kashmir,4570376,44841,3876688,693688,
02/07/2021,Jammu and Kashmir,4670310,99934,3948339,721971,
03/07/2021,Jammu and Kashmir,4759759,89449,4013073,746686,
04/07/2021,Jammu and Kashmir,4805884,46125,4051232,754652,
05/07/2021,Jammu and Kashmir,4872354,66470,4101877,770477,
06/07/2021,Jammu and Kashmir,4928467,56113,4147987,780480,
07/07/2021,Jammu and Kashmir,5003671,75204,4209146,794525,
08/07/2021,Jammu and Kashmir,5063909,60238,4253650,810259,
09/07/2021,Jammu and Kashmir,5088504,24595,4271861,816643,
10/07/2021,Jammu and Kashmir,5114832,26328,4293518,821314,
11/07/2021,Jammu and Kashmir,5149835,35003,4314400,835435,
12/07/2021,Jammu and Kashmir,5196038,46203,4339069,856969,
13/07/2021,Jammu and Kashmir,5223791,27753,4354531,869260,
14/07/2021,Jammu and Kashmir,5287631,63840,4411788,875843,
15/07/2021,Jammu and Kashmir,5363634,76003,4452507,911127,
16/07/2021,Jammu and Kashmir,5437313,73679,4489337,947976,
17/07/2021,Jammu and Kashmir,5482249,44936,4512931,969318,
18/07/2021,Jammu and Kashmir,5534891,52642,4544050,990841,
19/07/2021,Jammu and Kashmir,5622199,87308,4585652,1036547,
20/07/2021,Jammu and Kashmir,5676697,54498,4615137,1061560,
21/07/2021,Jammu and Kashmir,5687736,11039,4622017,1065719,
22/07/2021,Jammu and Kashmir,5698733,10997,4628601,1070132,
23/07/2021,Jammu and Kashmir,5734546,35813,4645667,1088879,
24/07/2021,Jammu and Kashmir,5820526,85980,4687048,1133478,
25/07/2021,Jammu and Kashmir,5861643,41117,4711124,1150519,
26/07/2021,Jammu and Kashmir,5921876,60233,4741621,1180255,
27/07/2021,Jammu and Kashmir,5958646,36770,4762219,1196427,
28/07/2021,Jammu and Kashmir,6033327,74681,4805043,1228284,
29/07/2021,Jammu and Kashmir,6104697,71370,4843934,1260763,
30/07/2021,Jammu and Kashmir,6161545,56848,4874004,1287541,
31/07/2021,Jammu and Kashmir,6215340,53795,4906292,1309048,
01/08/2021,Jammu and Kashmir,6304714,89374,4980566,1324148,
02/08/2021,Jammu and Kashmir,6385030,80316,5029174,1355856,
03/08/2021,Jammu and Kashmir,6450562,65532,5071021,1379541,
04/08/2021,Jammu and Kashmir,6486798,36236,5094403,1392395,
05/08/2021,Jammu and Kashmir,6550120,63322,5136611,1413509,
06/08/2021,Jammu and Kashmir,6603381,53261,5175260,1428121,
07/08/2021,Jammu and Kashmir,6690063,86682,5234547,1455516,
08/08/2021,Jammu and Kashmir,6737792,47729,5268567,1469225,
09/08/2021,Jammu and Kashmir,6808342,70550,5318516,1489826,
,,,,,,
,,,,,,
,,,,,,
,,,,,,
,,,,,,
,,,,,,
16/01/2021,Jharkhand,344,344,344,0,344
17/01/2021,Jharkhand,344,0,344,0,344
18/01/2021,Jharkhand,749,405,749,0,749
19/01/2021,Jharkhand,1455,706,1455,0,1455
20/01/2021,Jharkhand,2258,803,2258,0,2258
21/01/2021,Jharkhand,2258,0,2258,0,2258
22/01/2021,Jharkhand,4023,1765,4023,0,4023
23/01/2021,Jharkhand,4117,94,4117,0,4117
24/01/2021,Jharkhand,4573,456,4573,0,4573
25/01/2021,Jharkhand,8636,4063,8636,0,8636
26/01/2021,Jharkhand,8708,72,8708,0,8708
27/01/2021,Jharkhand,15269,6561,15269,0,15269
28/01/2021,Jharkhand,15617,348,15617,0,15617
29/01/2021,Jharkhand,23685,8068,23685,0,23685
30/01/2021,Jharkhand,31477,7792,31477,0,31477
31/01/2021,Jharkhand,31672,195,31672,0,31672
01/02/2021,Jharkhand,39147,7475,39147,0,39147
02/02/2021,Jharkhand,46900,7753,46900,0,46900
03/02/2021,Jharkhand,58991,12091,58991,0,58991
04/02/2021,Jharkhand,66209,7218,66209,0,66209
05/02/2021,Jharkhand,77034,10825,77034,0,77034
06/02/2021,Jharkhand,86786,9752,86786,0,86786
07/02/2021,Jharkhand,96697,9911,96697,0,96697
08/02/2021,Jharkhand,113951,17254,113951,0,113951
09/02/2021,Jharkhand,133247,19296,133247,0,133247
10/02/2021,Jharkhand,152985,19738,152985,0,152985
11/02/2021,Jharkhand,167957,14972,167957,0,167957
12/02/2021,Jharkhand,181722,13765,181722,0,181722
13/02/2021,Jharkhand,197934,16212,195956,1978,195956
14/02/2021,Jharkhand,205424,7490,203227,2197,203227
15/02/2021,Jharkhand,219873,14449,215731,4142,215731
16/02/2021,Jharkhand,228558,8685,222983,5575,222983
17/02/2021,Jharkhand,241010,12452,233318,7692,233318
18/02/2021,Jharkhand,249047,8037,240361,8686,240361
19/02/2021,Jharkhand,262687,13640,251913,10774,251913
20/02/2021,Jharkhand,271129,8442,259546,11583,259546
21/02/2021,Jharkhand,273466,2337,261700,11766,261700
22/02/2021,Jharkhand,281976,8510,268315,13661,268315
23/02/2021,Jharkhand,289373,7397,274560,14813,274560
24/02/2021,Jharkhand,298027,8654,279979,18048,279979
25/02/2021,Jharkhand,304309,6282,285072,19237,285072
26/02/2021,Jharkhand,313438,9129,289681,23757,289681
27/02/2021,Jharkhand,313438,0,289681,23757,289681
28/02/2021,Jharkhand,313438,0,289681,23757,289681
01/03/2021,Jharkhand,313438,0,289681,23757,289681
02/03/2021,Jharkhand,332286,18848,300236,32050,300236
03/03/2021,Jharkhand,350716,18430,312092,38624,312092
04/03/2021,Jharkhand,368393,17677,323632,44761,323632
05/03/2021,Jharkhand,389443,21050,336342,53101,336342
06/03/2021,Jharkhand,410219,20776,349329,60890,349329
07/03/2021,Jharkhand,416787,6568,353354,63433,353354
08/03/2021,Jharkhand,442754,25967,368526,74228,368526
09/03/2021,Jharkhand,402293,-40461,313825,88468,402293
10/03/2021,Jharkhand,433106,30813,328716,104390,433106
11/03/2021,Jharkhand,448191,15085,337413,110778,448191
12/03/2021,Jharkhand,480023,31832,354643,125380,480023
13/03/2021,Jharkhand,506986,26963,369293,137693,506986
14/03/2021,Jharkhand,526061,19075,381922,144139,526061
15/03/2021,Jharkhand,564865,38804,406491,158374,564865
16/03/2021,Jharkhand,691414,126549,520822,170592,520822
17/03/2021,Jharkhand,747474,56060,566563,180911,566563
18/03/2021,Jharkhand,779686,32212,589818,189868,589818
19/03/2021,Jharkhand,815129,35443,617091,198038,617091
20/03/2021,Jharkhand,922788,107659,716690,206098,716690
21/03/2021,Jharkhand,1087557,164769,877428,210129,877428
22/03/2021,Jharkhand,1131165,43608,914943,216222,914943
23/03/2021,Jharkhand,1286679,155514,1062427,224252,1062427
24/03/2021,Jharkhand,1406423,119744,1177165,229258,1177165
25/03/2021,Jharkhand,1448065,41642,1214880,233185,1214880
26/03/2021,Jharkhand,1510164,62099,1273664,236500,1273664
27/03/2021,Jharkhand,1609918,99754,1370655,239263,1370655
28/03/2021,Jharkhand,1624010,14092,1384612,239398,1384612
29/03/2021,Jharkhand,1625662,1652,1386163,239499,1386163
30/03/2021,Jharkhand,1636559,10897,1394924,241635,1394924
31/03/2021,Jharkhand,1660956,24397,1415140,245816,1415140
01/04/2021,Jharkhand,1686394,25438,1437104,249290,1437104
02/04/2021,Jharkhand,1729117,42723,1475614,253503,1475614
03/04/2021,Jharkhand,1758073,28956,1501006,257067,1501006
04/04/2021,Jharkhand,1839503,81430,1578359,261144,1578359
05/04/2021,Jharkhand,1913640,74137,1649049,264591,1649049
06/04/2021,Jharkhand,1973281,59641,1705435,267846,1705435
07/04/2021,Jharkhand,2062758,89477,1788075,274683,1788075
08/04/2021,Jharkhand,2134827,72069,1855020,279807,1855020
09/04/2021,Jharkhand,2162617,27790,1879293,283324,1879293
10/04/2021,Jharkhand,2260123,97506,1970433,289690,1970433
11/04/2021,Jharkhand,2359684,99561,2065113,294571,2065113
12/04/2021,Jharkhand,2429156,69472,2127045,302111,2127045
13/04/2021,Jharkhand,2505707,76551,2196926,308781,2196926
14/04/2021,Jharkhand,2595718,90011,2279843,315875,2279843
15/04/2021,Jharkhand,2640772,45054,2318245,322527,2318245
16/04/2021,Jharkhand,2681749,40977,2351517,330232,2351517
17/04/2021,Jharkhand,2733464,51715,2393775,339689,2393775
18/04/2021,Jharkhand,2775262,41798,2427024,348238,2427024
19/04/2021,Jharkhand,2807543,32281,2449014,358529,2449014
20/04/2021,Jharkhand,2848719,41176,2477515,371204,2477515
21/04/2021,Jharkhand,2877453,28734,2496708,380745,2496708
22/04/2021,Jharkhand,2901875,24422,2512136,389739,2512136
23/04/2021,Jharkhand,2935365,33490,2532881,402484,2532881
24/04/2021,Jharkhand,2965021,29656,2550782,414239,2550782
25/04/2021,Jharkhand,2977865,12844,2558670,419195,2558670
26/04/2021,Jharkhand,3005317,27452,2574711,430606,2574711
27/04/2021,Jharkhand,3029124,23807,2589148,439976,2589148
28/04/2021,Jharkhand,3053082,23958,2603179,449903,2603179
29/04/2021,Jharkhand,3083117,30035,2619343,463774,2619343
30/04/2021,Jharkhand,3114125,31008,2635993,478132,2635993
01/05/2021,Jharkhand,3135680,21555,2647485,488195,2647485
02/05/2021,Jharkhand,3146799,11119,2653112,493687,2653112
03/05/2021,Jharkhand,3165998,19199,2661873,504125,2661873
04/05/2021,Jharkhand,3186484,20486,2671304,515180,2671304
05/05/2021,Jharkhand,3211894,25410,2681933,529961,2681933
06/05/2021,Jharkhand,3233186,21292,2691611,541575,2691611
07/05/2021,Jharkhand,3257332,24146,2702393,554939,2702393
08/05/2021,Jharkhand,3284802,27470,2714194,570608,2714194
09/05/2021,Jharkhand,3303003,18201,2722859,580144,2722859
10/05/2021,Jharkhand,3336638,33635,2738946,597692,2738946
11/05/2021,Jharkhand,3373071,36433,2754830,618241,2754830
12/05/2021,Jharkhand,3402653,29582,2769962,632691,2769962
13/05/2021,Jharkhand,3428810,26157,2782611,646199,2782611
14/05/2021,Jharkhand,3480054,51244,2825315,654739,2825315
15/05/2021,Jharkhand,3541498,61444,2876996,664502,2876996
16/05/2021,Jharkhand,3585174,43676,2919090,666084,2919090
17/05/2021,Jharkhand,3640643,55469,2972741,667902,2972741
18/05/2021,Jharkhand,3692552,51909,3023461,669091,3023461
19/05/2021,Jharkhand,3743211,50659,3072388,670823,3072388
20/05/2021,Jharkhand,3791168,47957,3118200,672968,3118200
21/05/2021,Jharkhand,3840095,48927,3165104,674991,3165104
22/05/2021,Jharkhand,3877535,37440,3200833,676702,3200833
23/05/2021,Jharkhand,3922615,45080,3243983,678632,3243983
24/05/2021,Jharkhand,3973018,50403,3291812,681206,3291812
25/05/2021,Jharkhand,4012657,39639,3328296,684361,3328296
26/05/2021,Jharkhand,4037120,24463,3350619,686501,3350619
27/05/2021,Jharkhand,4053662,16542,3365244,688418,3365244
28/05/2021,Jharkhand,4084905,31243,3391607,693298,3391607
29/05/2021,Jharkhand,4124267,39362,3424365,699902,3424365
30/05/2021,Jharkhand,4156776,32509,3452239,704537,3452239
31/05/2021,Jharkhand,4194352,37576,3484293,710059,3484293
01/06/2021,Jharkhand,4227513,33161,3512443,715070,3512443
02/06/2021,Jharkhand,4266420,38907,3545235,721185,3545235
03/06/2021,Jharkhand,4306358,39938,3580164,726194,3580164
04/06/2021,Jharkhand,4378641,72283,3646348,732293,3646348
05/06/2021,Jharkhand,4470721,92080,3732019,738702,3732019
06/06/2021,Jharkhand,4549765,79044,3806892,742873,3806892
07/06/2021,Jharkhand,4613214,63449,3864177,749037,3864177
08/06/2021,Jharkhand,4673692,60478,3918642,755050,3918642
09/06/2021,Jharkhand,4732666,58974,3971153,761513,3971153
10/06/2021,Jharkhand,4802571,69905,4036613,765958,4036613
11/06/2021,Jharkhand,4896908,94337,4123823,773085,4123823
12/06/2021,Jharkhand,4998435,101527,4212899,785536,4212899
13/06/2021,Jharkhand,5107681,109246,4309176,798505,4309176
14/06/2021,Jharkhand,5200591,92910,4385314,815277,4385314
15/06/2021,Jharkhand,5275846,75255,4445031,830815,4445031
16/06/2021,Jharkhand,5351699,75853,4506462,845237,4506462
17/06/2021,Jharkhand,5439159,87460,4580622,858537,4580622
18/06/2021,Jharkhand,5546776,107617,4670691,876085,4670691
19/06/2021,Jharkhand,5656138,109362,4762333,893805,4762333
20/06/2021,Jharkhand,5778609,122471,4869438,909171,4869438
21/06/2021,Jharkhand,5883561,104952,4957150,926411,4957150
22/06/2021,Jharkhand,6000196,116635,5055364,944832,5055364
23/06/2021,Jharkhand,6131818,131622,5167917,963901,5167917
24/06/2021,Jharkhand,6255348,123530,5275892,979456,5275892
25/06/2021,Jharkhand,6403158,147810,5408550,994608,
26/06/2021,Jharkhand,6547873,144715,5536533,1011340,
27/06/2021,Jharkhand,6668652,120779,5640086,1028566,
28/06/2021,Jharkhand,6770349,101697,5724536,1045813,
29/06/2021,Jharkhand,6830286,59937,5771964,1058322,
30/06/2021,Jharkhand,6854142,23856,5789884,1064258,
01/07/2021,Jharkhand,6893417,39275,5821359,1072058,
02/07/2021,Jharkhand,6924097,30680,5846418,1077679,
03/07/2021,Jharkhand,7059365,135268,5948380,1110985,
04/07/2021,Jharkhand,7199780,140415,6053155,1146625,
05/07/2021,Jharkhand,7301080,101300,6126833,1174247,
06/07/2021,Jharkhand,7444490,143410,6227928,1216562,
07/07/2021,Jharkhand,7515450,70960,6276757,1238693,
08/07/2021,Jharkhand,7549569,34119,6301519,1248050,
09/07/2021,Jharkhand,7573202,23633,6318405,1254797,
10/07/2021,Jharkhand,7649649,76447,6368144,1281505,
11/07/2021,Jharkhand,7674657,25008,6385917,1288740,
12/07/2021,Jharkhand,7694498,19841,6400833,1293665,
13/07/2021,Jharkhand,7827456,132958,6479490,1347966,
14/07/2021,Jharkhand,7969071,141615,6584629,1384442,
15/07/2021,Jharkhand,8018791,49720,6620137,1398654,
16/07/2021,Jharkhand,8186347,167556,6726458,1459889,
17/07/2021,Jharkhand,8278886,92539,6794892,1483994,
18/07/2021,Jharkhand,8316876,37990,6824102,1492774,
19/07/2021,Jharkhand,8349211,32335,6848768,1500443,
20/07/2021,Jharkhand,8370920,21709,6864386,1506534,
21/07/2021,Jharkhand,8469011,98091,6932338,1536673,
22/07/2021,Jharkhand,8539989,70978,6980511,1559478,
23/07/2021,Jharkhand,8577086,37097,7008230,1568856,
24/07/2021,Jharkhand,8728808,151722,7120261,1608547,
25/07/2021,Jharkhand,8884178,155370,7241246,1642932,
26/07/2021,Jharkhand,9026731,142553,7351176,1675555,
27/07/2021,Jharkhand,9135518,108787,7436916,1698602,
28/07/2021,Jharkhand,9209878,74360,7496161,1713717,
29/07/2021,Jharkhand,9367956,158078,7613816,1754140,
30/07/2021,Jharkhand,9471180,103224,7689344,1781836,
31/07/2021,Jharkhand,9589764,118584,7776741,1813023,
01/08/2021,Jharkhand,9718188,128424,7883243,1834945,
02/08/2021,Jharkhand,9792734,74546,7935270,1857464,
03/08/2021,Jharkhand,9873698,80964,7992103,1881595,
04/08/2021,Jharkhand,9938490,64792,8040140,1898350,
05/08/2021,Jharkhand,10005289,66799,8089638,1915651,
06/08/2021,Jharkhand,10093868,88579,8159603,1934265,
07/08/2021,Jharkhand,10218231,124363,8257693,1960538,
08/08/2021,Jharkhand,10293046,74815,8315505,1977541,
09/08/2021,Jharkhand,10378294,85248,8382280,1996014,
,,,,,,
,,,,,,
,,,,,,
,,,,,,
,,,,,,
,,,,,,
16/01/2021,Karnataka,3810,3810,3810,0,3810
17/01/2021,Karnataka,4506,696,4506,0,4506
18/01/2021,Karnataka,14755,10249,14755,0,14755
19/01/2021,Karnataka,25142,10387,25142,0,25142
20/01/2021,Karnataka,36705,11563,36705,0,36705
21/01/2021,Karnataka,47344,10639,47344,0,47344
22/01/2021,Karnataka,77432,30088,77432,0,77432
23/01/2021,Karnataka,84585,7153,84585,0,84585
24/01/2021,Karnataka,93426,8841,93426,0,93426
25/01/2021,Karnataka,138721,45295,138721,0,138721
26/01/2021,Karnataka,140856,2135,140856,0,140856
27/01/2021,Karnataka,196089,55233,196089,0,196089
28/01/2021,Karnataka,215875,19786,215875,0,215875
29/01/2021,Karnataka,234619,18744,234619,0,234619
30/01/2021,Karnataka,246438,11819,246438,0,246438
31/01/2021,Karnataka,247613,1175,247613,0,247613
01/02/2021,Karnataka,249931,2318,249931,0,249931
02/02/2021,Karnataka,250715,784,250715,0,250715
03/02/2021,Karnataka,251723,1008,251723,0,251723
04/02/2021,Karnataka,265577,13854,265577,0,265577
05/02/2021,Karnataka,295307,29730,295307,0,295307
06/02/2021,Karnataka,321521,26214,321521,0,321521
07/02/2021,Karnataka,325554,4033,325554,0,325554
08/02/2021,Karnataka,350327,24773,350327,0,350327
09/02/2021,Karnataka,379152,28825,379152,0,379152
10/02/2021,Karnataka,403105,23953,403105,0,403105
11/02/2021,Karnataka,415241,12136,415241,0,415241
12/02/2021,Karnataka,430303,15062,430303,0,430303
13/02/2021,Karnataka,435685,5382,435670,15,435670
14/02/2021,Karnataka,435835,150,435820,15,435820
15/02/2021,Karnataka,462838,27003,451537,11301,451537
16/02/2021,Karnataka,501618,38780,473092,28526,473092
17/02/2021,Karnataka,560044,58426,505305,54739,505305
18/02/2021,Karnataka,537677,-22367,472428,65249,472428
19/02/2021,Karnataka,637368,99691,535611,101757,535611
20/02/2021,Karnataka,663860,26492,546779,117081,546779
21/02/2021,Karnataka,665580,1720,547587,117993,547587
22/02/2021,Karnataka,705083,39503,560544,144539,560544
23/02/2021,Karnataka,738792,33709,575708,163084,575708
24/02/2021,Karnataka,777394,38602,592088,185306,592088
25/02/2021,Karnataka,802101,24707,601961,200140,601961
26/02/2021,Karnataka,833025,30924,611335,221690,611335
27/02/2021,Karnataka,833025,0,611335,221690,611335
28/02/2021,Karnataka,833025,0,611335,221690,611335
01/03/2021,Karnataka,833025,0,611335,221690,611335
02/03/2021,Karnataka,845726,12701,621289,224437,621289
03/03/2021,Karnataka,860417,14691,633181,227236,633181
04/03/2021,Karnataka,875597,15180,645171,230426,645171
05/03/2021,Karnataka,897268,21671,661097,236171,661097
06/03/2021,Karnataka,923407,26139,678604,244803,678604
07/03/2021,Karnataka,925831,2424,680182,245649,680182
08/03/2021,Karnataka,994382,68551,729461,264921,729461
09/03/2021,Karnataka,788948,-205434,511728,277220,788948
10/03/2021,Karnataka,879486,90538,581668,297818,879486
11/03/2021,Karnataka,895719,16233,594042,301677,895719
12/03/2021,Karnataka,998460,102741,680155,318305,998460
13/03/2021,Karnataka,1048543,50083,723061,325482,1048543
14/03/2021,Karnataka,1067628,19085,741104,326524,1067628
15/03/2021,Karnataka,1233619,165991,893702,339917,1233619
16/03/2021,Karnataka,1621831,388212,1271286,350545,1271286
17/03/2021,Karnataka,2013637,391806,1649513,364124,1649513
18/03/2021,Karnataka,2124428,110791,1752016,372412,1752016
19/03/2021,Karnataka,2371563,247135,1987433,384130,1987433
20/03/2021,Karnataka,2578280,206717,2182510,395770,2182510
21/03/2021,Karnataka,2611299,33019,2214176,397123,2214176
22/03/2021,Karnataka,2806130,194831,2399962,406168,2399962
23/03/2021,Karnataka,2954336,148206,2539195,415141,2539195
24/03/2021,Karnataka,3140034,185698,2716069,423965,2716069
25/03/2021,Karnataka,3234506,94472,2805919,428587,2805919
26/03/2021,Karnataka,3396982,162476,2960802,436180,2960802
27/03/2021,Karnataka,3522500,125518,3080769,441731,3080769
28/03/2021,Karnataka,3542620,20120,3100377,442243,3100377
29/03/2021,Karnataka,3682325,139705,3234131,448194,3234131
30/03/2021,Karnataka,3800933,118608,3346567,454366,3346567
31/03/2021,Karnataka,3952215,151282,3489527,462688,3489527
01/04/2021,Karnataka,4066715,114500,3599566,467149,3599566
02/04/2021,Karnataka,4266426,199711,3793071,473355,3793071
03/04/2021,Karnataka,4450751,184325,3971518,479233,3971518
04/04/2021,Karnataka,4592345,141594,4108669,483676,4108669
05/04/2021,Karnataka,4765091,172746,4274168,490923,4274168
06/04/2021,Karnataka,4874443,109352,4378738,495705,4378738
07/04/2021,Karnataka,5193089,318646,4681696,511393,4681696
08/04/2021,Karnataka,5463170,270081,4936256,526914,4936256
09/04/2021,Karnataka,5788229,325059,5241266,546963,5241266
10/04/2021,Karnataka,6066457,278228,5502062,564395,5502062
11/04/2021,Karnataka,6208540,142083,5635988,572552,5635988
12/04/2021,Karnataka,6407151,198611,5814005,593146,5814005
13/04/2021,Karnataka,6446449,39298,5848181,598268,5848181
14/04/2021,Karnataka,6550378,103929,5935191,615187,5935191
15/04/2021,Karnataka,6704302,153924,6060959,643343,6060959
16/04/2021,Karnataka,6910211,205909,6226534,683677,6226534
17/04/2021,Karnataka,7191885,281674,6449119,742766,6449119
18/04/2021,Karnataka,7296541,104656,6532361,764180,6532361
19/04/2021,Karnataka,7542740,246199,6710926,831814,6710926
20/04/2021,Karnataka,7768341,225601,6871164,897177,6871164
21/04/2021,Karnataka,7957698,189357,7004724,952974,7004724
22/04/2021,Karnataka,8189265,231567,7158532,1030733,7158532
23/04/2021,Karnataka,8446284,257019,7334071,1112213,7334071
24/04/2021,Karnataka,8592838,146554,7439115,1153723,7439115
25/04/2021,Karnataka,8673546,80708,7495232,1178314,7495232
26/04/2021,Karnataka,8892099,218553,7631765,1260334,7631765
27/04/2021,Karnataka,9088000,195901,7750770,1337230,7750770
28/04/2021,Karnataka,9276973,188973,7864503,1412470,7864503
29/04/2021,Karnataka,9400272,123299,7940695,1459577,7940695
30/04/2021,Karnataka,9642439,242167,8090917,1551522,8090917
01/05/2021,Karnataka,9776943,134504,8178490,1598453,8178490
02/05/2021,Karnataka,9817518,40575,8204770,1612748,8204770
03/05/2021,Karnataka,9901051,83533,8253648,1647403,8253648
04/05/2021,Karnataka,9962735,61684,8289078,1673657,8289078
05/05/2021,Karnataka,10150823,188088,8387120,1763703,8387120
06/05/2021,Karnataka,10314190,163367,8468403,1845787,8468403
07/05/2021,Karnataka,10450470,136280,8527328,1923142,8527328
08/05/2021,Karnataka,10596894,146424,8577077,2019817,8577077
09/05/2021,Karnataka,10643323,46429,8591372,2051951,8591372
10/05/2021,Karnataka,10772140,128817,8638830,2133310,8638830
11/05/2021,Karnataka,10963129,190989,8718545,2244584,8718545
12/05/2021,Karnataka,11102044,138915,8792803,2309241,8792803
13/05/2021,Karnataka,11205478,103434,8851449,2354029,8851449
14/05/2021,Karnataka,11296508,91030,8885120,2411388,8885120
15/05/2021,Karnataka,11424456,127948,8927204,2497252,8927204
16/05/2021,Karnataka,11448846,24390,8942960,2505886,8942960
17/05/2021,Karnataka,11543880,95034,9017346,2526534,9017346
18/05/2021,Karnataka,11629177,85297,9091077,2538100,9091077
19/05/2021,Karnataka,11714719,85542,9162909,2551810,9162909
20/05/2021,Karnataka,11800829,86110,9228494,2572335,9228494
21/05/2021,Karnataka,11909365,108536,9307694,2601671,9307694
22/05/2021,Karnataka,12024591,115226,9407939,2616652,9407939
23/05/2021,Karnataka,12090122,65531,9468988,2621134,9468988
24/05/2021,Karnataka,12245538,155416,9612835,2632703,9612835
25/05/2021,Karnataka,12412615,167077,9770531,2642084,9770531
26/05/2021,Karnataka,12592227,179612,9939939,2652288,9939939
27/05/2021,Karnataka,12825223,232996,10154372,2670851,10154372
28/05/2021,Karnataka,13092345,267122,10393577,2698768,10393577
29/05/2021,Karnataka,13346630,254285,10625599,2721031,10625599
30/05/2021,Karnataka,13439808,93178,10709480,2730328,10709480
31/05/2021,Karnataka,13683390,243582,10929687,2753703,10929687
01/06/2021,Karnataka,13906541,223151,11133566,2772975,11133566
02/06/2021,Karnataka,14154710,248169,11363561,2791149,11363561
03/06/2021,Karnataka,14407706,252996,11596660,2811046,11596660
04/06/2021,Karnataka,14735361,327655,11899361,2836000,11899361
05/06/2021,Karnataka,15068597,333236,12206183,2862414,12206183
06/06/2021,Karnataka,15203304,134707,12333182,2870122,12333182
07/06/2021,Karnataka,15504527,301223,12612607,2891920,12612607
08/06/2021,Karnataka,15759842,255315,12847608,2912234,12847608
09/06/2021,Karnataka,15992599,232757,13058077,2934522,13058077
10/06/2021,Karnataka,16249047,256448,13294675,2954372,13294675
11/06/2021,Karnataka,16580369,331322,13599544,2980825,13599544
12/06/2021,Karnataka,16892231,311862,13885050,3007181,13885050
13/06/2021,Karnataka,16998892,106661,13985016,3013876,13985016
14/06/2021,Karnataka,17262828,263936,14219979,3042849,14219979
15/06/2021,Karnataka,17482779,219951,14412058,3070721,14412058
16/06/2021,Karnataka,17695431,212652,14594061,3101370,14594061
17/06/2021,Karnataka,17899357,203926,14771770,3127587,14771770
18/06/2021,Karnataka,18130798,231441,14971193,3159605,14971193
19/06/2021,Karnataka,18421390,290592,15205385,3216005,15205385
20/06/2021,Karnataka,18498363,76973,15268722,3229641,15268722
21/06/2021,Karnataka,19652759,1154396,16339169,3313590,16339169
22/06/2021,Karnataka,20104474,451715,16752226,3352248,16752226
23/06/2021,Karnataka,20512334,407860,17126371,3385963,17126371
24/06/2021,Karnataka,20921155,408821,17493598,3427557,17493598
25/06/2021,Karnataka,21341517,420362,17864741,3476776,
26/06/2021,Karnataka,21622289,280772,18089135,3533154,
27/06/2021,Karnataka,21750366,128077,18196068,3554298,
28/06/2021,Karnataka,22202542,452176,18563185,3639357,
29/06/2021,Karnataka,22470761,268219,18787206,3683555,
30/06/2021,Karnataka,22712414,241653,18973039,3739375,
01/07/2021,Karnataka,22911665,199251,19124712,3786953,
02/07/2021,Karnataka,23152094,240429,19293267,3858827,
03/07/2021,Karnataka,23639206,487112,19601804,4037402,
04/07/2021,Karnataka,23790590,151384,19703988,4086602,
05/07/2021,Karnataka,24185562,394972,19965810,4219752,
06/07/2021,Karnataka,24477242,291680,20169876,4307366,
07/07/2021,Karnataka,24739154,261912,20354749,4384405,
08/07/2021,Karnataka,24941814,202660,20494591,4447223,
09/07/2021,Karnataka,25276633,334819,20709063,4567570,
10/07/2021,Karnataka,25518726,242093,20854108,4664618,
11/07/2021,Karnataka,25624609,105883,20921104,4703505,
12/07/2021,Karnataka,25882198,257589,21086849,4795349,
13/07/2021,Karnataka,26042614,160416,21196915,4845699,
14/07/2021,Karnataka,26484472,441858,21531193,4953279,
15/07/2021,Karnataka,26614219,129747,21609700,5004519,
16/07/2021,Karnataka,26851134,236915,21741826,5109308,
17/07/2021,Karnataka,27211216,360082,21951177,5260039,
18/07/2021,Karnataka,27324330,113114,22018801,5305529,
19/07/2021,Karnataka,27595996,271666,22187924,5408072,
20/07/2021,Karnataka,27779600,183604,22304712,5474888,
21/07/2021,Karnataka,27957510,177910,22399536,5557974,
22/07/2021,Karnataka,28247972,290462,22570497,5677475,
23/07/2021,Karnataka,28558855,310883,22755810,5803045,
24/07/2021,Karnataka,28787936,229081,22885641,5902295,
25/07/2021,Karnataka,28886583,98647,22942185,5944398,
26/07/2021,Karnataka,29125539,238956,23073939,6051600,
27/07/2021,Karnataka,29417347,291808,23244325,6173022,
28/07/2021,Karnataka,29596896,179549,23352332,6244564,
29/07/2021,Karnataka,29725737,128841,23430600,6295137,
30/07/2021,Karnataka,30029134,303397,23623111,6406023,
31/07/2021,Karnataka,30371214,342080,23841981,6529233,
01/08/2021,Karnataka,30664762,293548,24087131,6577631,
02/08/2021,Karnataka,31396158,731396,24583845,6812313,
03/08/2021,Karnataka,31689767,293609,24789310,6900457,
04/08/2021,Karnataka,31957645,267878,24961046,6996599,
05/08/2021,Karnataka,32124981,167336,25060031,7064950,
06/08/2021,Karnataka,32349726,224745,25189842,7159884,
07/08/2021,Karnataka,32764656,414930,25468918,7295738,
08/08/2021,Karnataka,32925156,160500,25590067,7335089,
09/08/2021,Karnataka,33280543,355387,25847691,7432852,
,,,,,,
,,,,,,
,,,,,,
,,,,,,
,,,,,,
,,,,,,
16/01/2021,Kerala,1681,1681,1681,0,1681
17/01/2021,Kerala,1836,155,1836,0,1836
18/01/2021,Kerala,2566,730,2566,0,2566
19/01/2021,Kerala,5355,2789,5355,0,5355
20/01/2021,Kerala,5398,43,5398,0,5398
21/01/2021,Kerala,9175,3777,9175,0,9175
22/01/2021,Kerala,15501,6326,15501,0,15501
23/01/2021,Kerala,21944,6443,21944,0,21944
24/01/2021,Kerala,23324,1380,23324,0,23324
25/01/2021,Kerala,43561,20237,43561,0,43561
26/01/2021,Kerala,43766,205,43766,0,43766
27/01/2021,Kerala,58323,14557,58323,0,58323
28/01/2021,Kerala,82794,24471,82794,0,82794
29/01/2021,Kerala,110719,27925,110719,0,110719
30/01/2021,Kerala,134225,23506,134225,0,134225
31/01/2021,Kerala,140906,6681,140906,0,140906
01/02/2021,Kerala,173482,32576,173482,0,173482
02/02/2021,Kerala,204449,30967,204449,0,204449
03/02/2021,Kerala,225664,21215,225664,0,225664
04/02/2021,Kerala,250831,25167,250831,0,250831
05/02/2021,Kerala,266068,15237,266068,0,266068
06/02/2021,Kerala,271731,5663,271731,0,271731
07/02/2021,Kerala,272221,490,272221,0,272221
08/02/2021,Kerala,287787,15566,287787,0,287787
09/02/2021,Kerala,302655,14868,302655,0,302655
10/02/2021,Kerala,306802,4147,306802,0,306802
11/02/2021,Kerala,314425,7623,314425,0,314425
12/02/2021,Kerala,326974,12549,326974,0,326974
13/02/2021,Kerala,338167,11193,338167,0,338167
14/02/2021,Kerala,340452,2285,340407,45,340407
15/02/2021,Kerala,357263,16811,353940,3323,353940
16/02/2021,Kerala,382629,25366,370481,12148,370481
17/02/2021,Kerala,392764,10135,377376,15388,377376
18/02/2021,Kerala,401317,8553,377981,23336,377981
19/02/2021,Kerala,432564,31247,400463,32101,400463
20/02/2021,Kerala,445561,12997,406728,38833,406728
21/02/2021,Kerala,445939,378,407098,38841,407098
22/02/2021,Kerala,469633,23694,413599,56034,413599
23/02/2021,Kerala,484753,15120,422676,62077,422676
24/02/2021,Kerala,501243,16490,431070,70173,431070
25/02/2021,Kerala,538367,37124,449826,88541,449826
26/02/2021,Kerala,593333,54966,489113,104220,489113
27/02/2021,Kerala,593333,0,489113,104220,489113
28/02/2021,Kerala,593333,0,489113,104220,489113
01/03/2021,Kerala,593333,0,489113,104220,489113
02/03/2021,Kerala,653199,59866,534490,118709,534490
03/03/2021,Kerala,691858,38659,564199,127659,564199
04/03/2021,Kerala,774938,83080,627900,147038,627900
05/03/2021,Kerala,856197,81259,689867,166330,689867
06/03/2021,Kerala,943171,86974,756016,187155,756016
07/03/2021,Kerala,956327,13156,767969,188358,767969
08/03/2021,Kerala,1038770,82443,829751,209019,829751
09/03/2021,Kerala,918350,-120420,689979,228371,918350
10/03/2021,Kerala,954881,36531,714468,240413,954881
11/03/2021,Kerala,992154,37273,742190,249964,992154
12/03/2021,Kerala,1077367,85213,807213,270154,1077367
13/03/2021,Kerala,1123556,46189,843361,280195,1123556
14/03/2021,Kerala,1127845,4289,846852,280993,1127845
15/03/2021,Kerala,1213086,85241,915549,297537,1213086
16/03/2021,Kerala,1500473,287387,1188099,312374,1188099
17/03/2021,Kerala,2016703,516230,1695387,321316,1695387
18/03/2021,Kerala,2165652,148949,1832205,333447,1832205
19/03/2021,Kerala,2298455,132803,1954868,343587,1954868
20/03/2021,Kerala,2418931,120476,2066624,352307,2066624
21/03/2021,Kerala,2426827,7896,2073902,352925,2073902
22/03/2021,Kerala,2564049,137222,2203735,360314,2203735
23/03/2021,Kerala,2712712,148663,2339164,373548,2339164
24/03/2021,Kerala,2776155,63443,2398567,377588,2398567
25/03/2021,Kerala,2939242,163087,2555550,383692,2555550
26/03/2021,Kerala,3070352,131110,2682089,388263,2682089
27/03/2021,Kerala,3188068,117716,2795930,392138,2795930
28/03/2021,Kerala,3199659,11591,2807351,392308,2807351
29/03/2021,Kerala,3353041,153382,2956227,396814,2956227
30/03/2021,Kerala,3510207,157166,3106682,403525,3106682
31/03/2021,Kerala,3574857,64650,3167015,407842,3167015
01/04/2021,Kerala,3653814,78957,3242747,411067,3242747
02/04/2021,Kerala,3721899,68085,3307374,414525,3307374
03/04/2021,Kerala,3838483,116584,3416400,422083,3416400
04/04/2021,Kerala,3888331,49848,3463563,424768,3463563
05/04/2021,Kerala,4005217,116886,3573568,431649,3573568
06/04/2021,Kerala,4042344,37127,3608126,434218,3608126
07/04/2021,Kerala,4140687,98343,3698854,441833,3698854
08/04/2021,Kerala,4356948,216261,3899533,457415,3899533
09/04/2021,Kerala,4575579,218631,4099009,476570,4099009
10/04/2021,Kerala,4763750,188171,4270854,492896,4270854
11/04/2021,Kerala,4830666,66916,4333798,496868,4333798
12/04/2021,Kerala,5098015,267349,4571524,526491,4571524
13/04/2021,Kerala,5267173,169158,4714085,553088,4714085
14/04/2021,Kerala,5287486,20313,4730173,557313,4730173
15/04/2021,Kerala,5496553,209067,4899502,597051,4899502
16/04/2021,Kerala,5680114,183561,5040807,639307,5040807
17/04/2021,Kerala,5832548,152434,5158591,673957,5158591
18/04/2021,Kerala,5870232,37684,5189796,680436,5189796
19/04/2021,Kerala,6026332,156100,5299053,727279,5299053
20/04/2021,Kerala,6243615,217283,5443386,800229,5443386
21/04/2021,Kerala,6353600,109985,5512304,841296,5512304
22/04/2021,Kerala,6503034,149434,5602945,900089,5602945
23/04/2021,Kerala,6628388,125354,5673943,954445,5673943
24/04/2021,Kerala,6827755,199367,5788568,1039187,5788568
25/04/2021,Kerala,6847075,19320,5801281,1045794,5801281
26/04/2021,Kerala,6991118,144043,5885170,1105948,5885170
27/04/2021,Kerala,7106942,115824,5947361,1159581,5947361
28/04/2021,Kerala,7144083,37141,5967887,1176196,5967887
29/04/2021,Kerala,7229177,85094,6006391,1222786,6006391
30/04/2021,Kerala,7376934,147757,6051350,1325584,6051350
01/05/2021,Kerala,7425416,48482,6069726,1355690,6069726
02/05/2021,Kerala,7426176,760,6069760,1356416,6069760
03/05/2021,Kerala,7511454,85278,6092349,1419105,6092349
04/05/2021,Kerala,7577304,65850,6110419,1466885,6110419
05/05/2021,Kerala,7600484,23180,6118358,1482126,6118358
06/05/2021,Kerala,7705285,104801,6137985,1567300,6137985
07/05/2021,Kerala,7869269,163984,6168780,1700489,6168780
08/05/2021,Kerala,7951983,82714,6187280,1764703,6187280
09/05/2021,Kerala,7952556,573,6187652,1764904,6187652
10/05/2021,Kerala,8066700,114144,6216882,1849818,6216882
11/05/2021,Kerala,8141289,74589,6238776,1902513,6238776
12/05/2021,Kerala,8185506,44217,6257014,1928492,6257014
13/05/2021,Kerala,8212961,27455,6267551,1945410,6267551
14/05/2021,Kerala,8259812,46851,6290354,1969458,6290354
15/05/2021,Kerala,8417840,158028,6426197,1991643,6426197
16/05/2021,Kerala,8451480,33640,6454137,1997343,6454137
17/05/2021,Kerala,8519852,68372,6510777,2009075,6510777
18/05/2021,Kerala,8573567,53715,6556628,2016939,6556628
19/05/2021,Kerala,8591102,17535,6571984,2019118,6571984
20/05/2021,Kerala,8599407,8305,6579668,2019739,6579668
21/05/2021,Kerala,8614950,15543,6594479,2020471,6594479
22/05/2021,Kerala,8644281,29331,6623765,2020516,6623765
23/05/2021,Kerala,8650237,5956,6629725,2020512,6629725
24/05/2021,Kerala,8703631,53394,6683003,2020628,6683003
25/05/2021,Kerala,8759506,55875,6738751,2020755,6738751
26/05/2021,Kerala,8789981,30475,6769136,2020845,6769136
27/05/2021,Kerala,8904096,114115,6881450,2022646,6881450
28/05/2021,Kerala,9056314,152218,7031363,2024951,7031363
29/05/2021,Kerala,9215371,159057,7170607,2044764,7170607
30/05/2021,Kerala,9241456,26085,7190905,2050551,7190905
31/05/2021,Kerala,9413723,172267,7345141,2068582,7345141
01/06/2021,Kerala,9583560,169837,7494522,2089038,7494522
02/06/2021,Kerala,9689249,105689,7585560,2103689,7585560
03/06/2021,Kerala,9850288,161039,7730989,2119299,7730989
04/06/2021,Kerala,10026627,176339,7888884,2137743,7888884
05/06/2021,Kerala,10214963,188336,8057972,2156991,8057972
06/06/2021,Kerala,10270131,55168,8109567,2160564,8109567
07/06/2021,Kerala,10473049,202918,8302066,2170983,8302066
08/06/2021,Kerala,10692008,218959,8503125,2188883,8503125
09/06/2021,Kerala,10832105,140097,8634128,2197977,8634128
10/06/2021,Kerala,10983039,150934,8772285,2210754,8772285
11/06/2021,Kerala,11102819,119780,8879020,2223799,8879020
12/06/2021,Kerala,11181355,78536,8943648,2237707,8943648
13/06/2021,Kerala,11229829,48474,8989689,2240140,8989689
14/06/2021,Kerala,11422135,192306,9154064,2268071,9154064
15/06/2021,Kerala,11635416,213281,9307169,2328247,9307169
16/06/2021,Kerala,11746936,111520,9386066,2360870,9386066
17/06/2021,Kerala,11895426,148490,9504983,2390443,9504983
18/06/2021,Kerala,11996311,100885,9589345,2406966,9589345
19/06/2021,Kerala,12103202,106891,9676904,2426298,9676904
20/06/2021,Kerala,12161549,58347,9719116,2442433,9719116
21/06/2021,Kerala,12431202,269653,9878112,2553090,9878112
22/06/2021,Kerala,12668936,237734,10022247,2646689,10022247
23/06/2021,Kerala,12837481,168545,10116957,2720524,10116957
24/06/2021,Kerala,13061640,224159,10258975,2802665,10258975
25/06/2021,Kerala,13304025,242385,10402196,2901829,
26/06/2021,Kerala,13483338,179313,10506089,2977249,
27/06/2021,Kerala,13535878,52540,10541450,2994428,
28/06/2021,Kerala,13748651,212773,10649612,3099039,
29/06/2021,Kerala,13948645,199994,10748505,3200140,
30/06/2021,Kerala,14095726,147081,10841514,3254212,
01/07/2021,Kerala,14242696,146970,10915717,3326979,
02/07/2021,Kerala,14531577,288881,11043945,3487632,
03/07/2021,Kerala,14764538,232961,11162817,3601721,
04/07/2021,Kerala,14790452,25914,11179952,3610500,
05/07/2021,Kerala,14947001,156549,11261270,3685731,
06/07/2021,Kerala,15062316,115315,11322761,3739555,
07/07/2021,Kerala,15120585,58269,11356275,3764310,
08/07/2021,Kerala,15221414,100829,11393122,3828292,
09/07/2021,Kerala,15412596,191182,11454395,3958201,
10/07/2021,Kerala,15667228,254632,11544597,4122631,
11/07/2021,Kerala,15700974,33746,11559011,4141963,
12/07/2021,Kerala,15911270,210296,11633723,4277547,
13/07/2021,Kerala,16059858,148588,11695199,4364659,
14/07/2021,Kerala,16206261,146403,11787878,4418383,
15/07/2021,Kerala,16360256,153995,11856125,4504131,
16/07/2021,Kerala,16485990,125734,11918604,4567386,
17/07/2021,Kerala,16650485,164495,11989687,4660798,
18/07/2021,Kerala,16704293,53808,12021046,4683247,
19/07/2021,Kerala,17058684,354391,12156815,4901869,
20/07/2021,Kerala,17329394,270710,12277830,5051564,
21/07/2021,Kerala,17427952,98558,12340361,5087591,
22/07/2021,Kerala,17709317,281365,12464564,5244753,
23/07/2021,Kerala,17976287,266970,12585905,5390382,
24/07/2021,Kerala,18464206,487919,12877004,5587202,
25/07/2021,Kerala,18594259,130053,12972001,5622258,
26/07/2021,Kerala,18811780,217521,13128347,5683433,
27/07/2021,Kerala,18942910,131130,13233990,5708920,
28/07/2021,Kerala,19009970,67060,13292691,5717279,
29/07/2021,Kerala,19271174,261204,13465864,5805310,
30/07/2021,Kerala,19781866,510692,13811980,5969886,
31/07/2021,Kerala,20165100,383234,14111255,6053845,
01/08/2021,Kerala,20369496,204396,14284456,6085040,
02/08/2021,Kerala,20720223,350727,14566582,6153641,
03/08/2021,Kerala,21008073,287850,14804327,6203746,
04/08/2021,Kerala,21114463,106390,14882715,6231748,
05/08/2021,Kerala,21303369,188906,15033777,6269592,
06/08/2021,Kerala,21560396,257027,15231449,6328947,
07/08/2021,Kerala,21782429,222033,15416834,6365595,
08/08/2021,Kerala,21843327,60898,15472524,6370803,
09/08/2021,Kerala,22097731,254404,15670747,6426984,
,,,,,,
,,,,,,
,,,,,,
,,,,,,
,,,,,,
,,,,,,
16/01/2021,Ladakh,9,9,9,0,9
17/01/2021,Ladakh,9,0,9,0,9
18/01/2021,Ladakh,64,55,64,0,64
19/01/2021,Ladakh,64,0,64,0,64
20/01/2021,Ladakh,66,2,66,0,66
21/01/2021,Ladakh,66,0,66,0,66
22/01/2021,Ladakh,164,98,164,0,164
23/01/2021,Ladakh,330,166,330,0,330
24/01/2021,Ladakh,337,7,337,0,337
25/01/2021,Ladakh,461,124,461,0,461
26/01/2021,Ladakh,461,0,461,0,461
27/01/2021,Ladakh,642,181,642,0,642
28/01/2021,Ladakh,652,10,652,0,652
29/01/2021,Ladakh,823,171,823,0,823
30/01/2021,Ladakh,959,136,959,0,959
31/01/2021,Ladakh,959,0,959,0,959
01/02/2021,Ladakh,1065,106,1065,0,1065
02/02/2021,Ladakh,1065,0,1065,0,1065
03/02/2021,Ladakh,1342,277,1342,0,1342
04/02/2021,Ladakh,1342,0,1342,0,1342
05/02/2021,Ladakh,1578,236,1578,0,1578
06/02/2021,Ladakh,1817,239,1817,0,1817
07/02/2021,Ladakh,1817,0,1817,0,1817
08/02/2021,Ladakh,2064,247,2064,0,2064
09/02/2021,Ladakh,2158,94,2158,0,2158
10/02/2021,Ladakh,2379,221,2379,0,2379
11/02/2021,Ladakh,2597,218,2597,0,2597
12/02/2021,Ladakh,2695,98,2695,0,2695
13/02/2021,Ladakh,2902,207,2831,71,2831
14/02/2021,Ladakh,2902,0,2831,71,2831
15/02/2021,Ladakh,3014,112,2887,127,2887
16/02/2021,Ladakh,3602,588,3433,169,3433
17/02/2021,Ladakh,4162,560,3931,231,3931
18/02/2021,Ladakh,4572,410,4284,288,4284
19/02/2021,Ladakh,5531,959,5175,356,5175
20/02/2021,Ladakh,6383,852,5783,600,5783
21/02/2021,Ladakh,6621,238,6021,600,6021
22/02/2021,Ladakh,7460,839,6748,712,6748
23/02/2021,Ladakh,8432,972,7719,713,7719
24/02/2021,Ladakh,9243,811,8396,847,8396
25/02/2021,Ladakh,9734,491,8887,847,8887
26/02/2021,Ladakh,10341,607,9412,929,9412
27/02/2021,Ladakh,10341,0,9412,929,9412
28/02/2021,Ladakh,10341,0,9412,929,9412
01/03/2021,Ladakh,10341,0,9412,929,9412
02/03/2021,Ladakh,11130,789,9990,1140,9990
03/03/2021,Ladakh,12205,1075,10778,1427,10778
04/03/2021,Ladakh,13048,843,11538,1510,11538
05/03/2021,Ladakh,14139,1091,12393,1746,12393
06/03/2021,Ladakh,16365,2226,14387,1978,14387
07/03/2021,Ladakh,16365,0,14387,1978,14387
08/03/2021,Ladakh,19096,2731,16882,2214,16882
09/03/2021,Ladakh,20455,1359,18159,2296,20455
10/03/2021,Ladakh,23584,3129,21085,2499,23584
11/03/2021,Ladakh,26595,3011,23882,2713,26595
12/03/2021,Ladakh,29215,2620,26413,2802,29215
13/03/2021,Ladakh,31815,2600,28917,2898,31815
14/03/2021,Ladakh,32385,570,29485,2900,32385
15/03/2021,Ladakh,34683,2298,31760,2923,34683
16/03/2021,Ladakh,38926,4243,35573,3353,35573
17/03/2021,Ladakh,40726,1800,37044,3682,37044
18/03/2021,Ladakh,42033,1307,37810,4223,37810
19/03/2021,Ladakh,43189,1156,38440,4749,38440
20/03/2021,Ladakh,44169,980,38954,5215,38954
21/03/2021,Ladakh,44234,65,39005,5229,39005
22/03/2021,Ladakh,45135,901,39419,5716,39419
23/03/2021,Ladakh,45814,679,39767,6047,39767
24/03/2021,Ladakh,46093,279,39950,6143,39950
25/03/2021,Ladakh,46261,168,40010,6251,40010
26/03/2021,Ladakh,46461,200,40083,6378,40083
27/03/2021,Ladakh,46590,129,40195,6395,40195
28/03/2021,Ladakh,46589,-1,40194,6395,40194
29/03/2021,Ladakh,46588,-1,40193,6395,40193
30/03/2021,Ladakh,46645,57,40215,6430,40215
31/03/2021,Ladakh,46872,227,40372,6500,40372
01/04/2021,Ladakh,50362,3490,43815,6547,43815
02/04/2021,Ladakh,55631,5269,49045,6586,49045
03/04/2021,Ladakh,59338,3707,52707,6631,52707
04/04/2021,Ladakh,62214,2876,55578,6636,55578
05/04/2021,Ladakh,65089,2875,58417,6672,58417
06/04/2021,Ladakh,66613,1524,59863,6750,59863
07/04/2021,Ladakh,69391,2778,62372,7019,62372
08/04/2021,Ladakh,71259,1868,63903,7356,63903
09/04/2021,Ladakh,71960,701,64284,7676,64284
10/04/2021,Ladakh,72431,471,64518,7913,64518
11/04/2021,Ladakh,73397,966,65236,8161,65236
12/04/2021,Ladakh,74608,1211,66115,8493,66115
13/04/2021,Ladakh,75319,711,66540,8779,66540
14/04/2021,Ladakh,75905,586,66813,9092,66813
15/04/2021,Ladakh,76470,565,66918,9552,66918
16/04/2021,Ladakh,76968,498,67005,9963,67005
17/04/2021,Ladakh,77819,851,67157,10662,67157
18/04/2021,Ladakh,77857,38,67185,10672,67185
19/04/2021,Ladakh,80595,2738,67732,12863,67732
20/04/2021,Ladakh,84637,4042,68954,15683,68954
21/04/2021,Ladakh,88412,3775,69995,18417,69995
22/04/2021,Ladakh,91310,2898,70599,20711,70599
23/04/2021,Ladakh,94316,3006,71353,22963,71353
24/04/2021,Ladakh,96539,2223,71714,24825,71714
25/04/2021,Ladakh,96956,417,71734,25222,71734
26/04/2021,Ladakh,100903,3947,72754,28149,72754
27/04/2021,Ladakh,103717,2814,73508,30209,73508
28/04/2021,Ladakh,105808,2091,73967,31841,73967
29/04/2021,Ladakh,107405,1597,74391,33014,74391
30/04/2021,Ladakh,108166,761,74571,33595,74571
01/05/2021,Ladakh,109442,1276,74984,34458,74984
02/05/2021,Ladakh,109696,254,75065,34631,75065
03/05/2021,Ladakh,111070,1374,75744,35326,75744
04/05/2021,Ladakh,112903,1833,77322,35581,77322
05/05/2021,Ladakh,115161,2258,79276,35885,79276
06/05/2021,Ladakh,117233,2072,81061,36172,81061
07/05/2021,Ladakh,118299,1066,81960,36339,81960
08/05/2021,Ladakh,119520,1221,83032,36488,83032
09/05/2021,Ladakh,119661,141,83169,36492,83169
10/05/2021,Ladakh,120835,1174,84093,36742,84093
11/05/2021,Ladakh,121529,694,84630,36899,84630
12/05/2021,Ladakh,122218,689,85240,36978,85240
13/05/2021,Ladakh,122800,582,85688,37112,85688
14/05/2021,Ladakh,122800,0,85688,37112,85688
15/05/2021,Ladakh,123897,1097,86645,37252,86645
16/05/2021,Ladakh,123897,0,86645,37252,86645
17/05/2021,Ladakh,124756,859,87501,37255,87501
18/05/2021,Ladakh,125747,991,88488,37259,88488
19/05/2021,Ladakh,126974,1227,89715,37259,89715
20/05/2021,Ladakh,128323,1349,91064,37259,91064
21/05/2021,Ladakh,130332,2009,93073,37259,93073
22/05/2021,Ladakh,132064,1732,94805,37259,94805
23/05/2021,Ladakh,132137,73,94878,37259,94878
24/05/2021,Ladakh,134067,1930,96802,37265,96802
25/05/2021,Ladakh,136294,2227,99028,37266,99028
26/05/2021,Ladakh,138454,2160,101188,37266,101188
27/05/2021,Ladakh,144321,5867,107044,37277,107044
28/05/2021,Ladakh,150092,5771,112814,37278,112814
29/05/2021,Ladakh,154115,4023,116836,37279,116836
30/05/2021,Ladakh,154135,20,116856,37279,116856
31/05/2021,Ladakh,159496,5361,122206,37290,122206
01/06/2021,Ladakh,164155,4659,126864,37291,126864
02/06/2021,Ladakh,167934,3779,130639,37295,130639
03/06/2021,Ladakh,171395,3461,134095,37300,134095
04/06/2021,Ladakh,174899,3504,137598,37301,137598
05/06/2021,Ladakh,177678,2779,140366,37312,140366
06/06/2021,Ladakh,177681,3,140369,37312,140369
07/06/2021,Ladakh,180269,2588,142943,37326,142943
08/06/2021,Ladakh,181714,1445,144376,37338,144376
09/06/2021,Ladakh,183376,1662,146030,37346,146030
10/06/2021,Ladakh,185674,2298,148313,37361,148313
11/06/2021,Ladakh,189143,3469,151780,37363,151780
12/06/2021,Ladakh,191063,1920,153682,37381,153682
13/06/2021,Ladakh,191066,3,153685,37381,153685
14/06/2021,Ladakh,192431,1365,155038,37393,155038
15/06/2021,Ladakh,193330,899,155927,37403,155927
16/06/2021,Ladakh,194501,1171,157081,37420,157081
17/06/2021,Ladakh,196717,2216,159275,37442,159275
18/06/2021,Ladakh,198155,1438,160703,37452,160703
19/06/2021,Ladakh,199286,1131,161809,37477,161809
20/06/2021,Ladakh,199286,0,161809,37477,161809
21/06/2021,Ladakh,200706,1420,163217,37489,163217
22/06/2021,Ladakh,202329,1623,164799,37530,164799
23/06/2021,Ladakh,203725,1396,166167,37558,166167
24/06/2021,Ladakh,206992,3267,167571,39421,167571
25/06/2021,Ladakh,211520,4528,168168,43352,
26/06/2021,Ladakh,215964,4444,168671,47293,
27/06/2021,Ladakh,216616,652,168691,47925,
28/06/2021,Ladakh,220989,4373,169421,51568,
29/06/2021,Ladakh,224630,3641,170297,54333,
30/06/2021,Ladakh,226801,2171,170900,55901,
01/07/2021,Ladakh,228809,2008,171439,57370,
02/07/2021,Ladakh,230087,1278,172099,57988,
03/07/2021,Ladakh,232133,2046,173803,58330,
04/07/2021,Ladakh,232795,662,174447,58348,
05/07/2021,Ladakh,235427,2632,176300,59127,
06/07/2021,Ladakh,237455,2028,177760,59695,
07/07/2021,Ladakh,238305,850,178128,60177,
08/07/2021,Ladakh,239589,1284,179174,60415,
09/07/2021,Ladakh,240818,1229,180257,60561,
10/07/2021,Ladakh,242115,1297,181385,60730,
11/07/2021,Ladakh,242545,430,181815,60730,
12/07/2021,Ladakh,243556,1011,182438,61118,
13/07/2021,Ladakh,244282,726,182773,61509,
14/07/2021,Ladakh,246067,1785,184350,61717,
15/07/2021,Ladakh,246543,476,184640,61903,
16/07/2021,Ladakh,246776,233,184757,62019,
17/07/2021,Ladakh,247139,363,184970,62169,
18/07/2021,Ladakh,247199,60,185017,62182,
19/07/2021,Ladakh,247527,328,185146,62381,
20/07/2021,Ladakh,247824,297,185298,62526,
21/07/2021,Ladakh,247824,0,185298,62526,
22/07/2021,Ladakh,248319,495,185475,62844,
23/07/2021,Ladakh,248685,366,185654,63031,
24/07/2021,Ladakh,249041,356,185770,63271,
25/07/2021,Ladakh,249041,0,185770,63271,
26/07/2021,Ladakh,249727,686,186038,63689,
27/07/2021,Ladakh,250768,1041,186256,64512,
28/07/2021,Ladakh,252103,1335,186477,65626,
29/07/2021,Ladakh,252857,754,186751,66106,
30/07/2021,Ladakh,253924,1067,186894,67030,
31/07/2021,Ladakh,254727,803,187081,67646,
01/08/2021,Ladakh,255047,320,187393,67654,
02/08/2021,Ladakh,255738,691,187602,68136,
03/08/2021,Ladakh,256201,463,187750,68451,
04/08/2021,Ladakh,256621,420,187859,68762,
05/08/2021,Ladakh,257040,419,188002,69038,
06/08/2021,Ladakh,257551,511,188226,69325,
07/08/2021,Ladakh,258385,834,188426,69959,
08/08/2021,Ladakh,258385,0,188426,69959,
09/08/2021,Ladakh,259036,651,188699,70337,
,,,,,,
,,,,,,
,,,,,,
,,,,,,
,,,,,,
,,,,,,
16/01/2021,Lakshadweep,16,16,16,0,16
17/01/2021,Lakshadweep,17,1,17,0,17
18/01/2021,Lakshadweep,237,220,237,0,237
19/01/2021,Lakshadweep,622,385,622,0,622
20/01/2021,Lakshadweep,629,7,629,0,629
21/01/2021,Lakshadweep,724,95,724,0,724
22/01/2021,Lakshadweep,734,10,734,0,734
23/01/2021,Lakshadweep,734,0,734,0,734
24/01/2021,Lakshadweep,749,15,749,0,749
25/01/2021,Lakshadweep,752,3,752,0,752
26/01/2021,Lakshadweep,752,0,752,0,752
27/01/2021,Lakshadweep,765,13,765,0,765
28/01/2021,Lakshadweep,790,25,790,0,790
29/01/2021,Lakshadweep,807,17,807,0,807
30/01/2021,Lakshadweep,807,0,807,0,807
31/01/2021,Lakshadweep,807,0,807,0,807
01/02/2021,Lakshadweep,807,0,807,0,807
02/02/2021,Lakshadweep,807,0,807,0,807
03/02/2021,Lakshadweep,807,0,807,0,807
04/02/2021,Lakshadweep,807,0,807,0,807
05/02/2021,Lakshadweep,825,18,825,0,825
06/02/2021,Lakshadweep,833,8,833,0,833
07/02/2021,Lakshadweep,833,0,833,0,833
08/02/2021,Lakshadweep,839,6,839,0,839
09/02/2021,Lakshadweep,869,30,869,0,869
10/02/2021,Lakshadweep,1312,443,1312,0,1312
11/02/2021,Lakshadweep,1344,32,1344,0,1344
12/02/2021,Lakshadweep,1575,231,1575,0,1575
13/02/2021,Lakshadweep,1575,0,1575,0,1575
14/02/2021,Lakshadweep,1575,0,1575,0,1575
15/02/2021,Lakshadweep,1575,0,1575,0,1575
16/02/2021,Lakshadweep,1613,38,1594,19,1594
17/02/2021,Lakshadweep,1613,0,1594,19,1594
18/02/2021,Lakshadweep,1674,61,1623,51,1623
19/02/2021,Lakshadweep,1770,96,1689,81,1689
20/02/2021,Lakshadweep,1770,0,1689,81,1689
21/02/2021,Lakshadweep,1770,0,1689,81,1689
22/02/2021,Lakshadweep,1830,60,1748,82,1748
23/02/2021,Lakshadweep,1877,47,1771,106,1771
24/02/2021,Lakshadweep,1902,25,1796,106,1796
25/02/2021,Lakshadweep,1929,27,1822,107,1822
26/02/2021,Lakshadweep,1931,2,1824,107,1824
27/02/2021,Lakshadweep,1931,0,1824,107,1824
28/02/2021,Lakshadweep,1931,0,1824,107,1824
01/03/2021,Lakshadweep,1931,0,1824,107,1824
02/03/2021,Lakshadweep,1931,0,1824,107,1824
03/03/2021,Lakshadweep,1931,0,1824,107,1824
04/03/2021,Lakshadweep,1931,0,1824,107,1824
05/03/2021,Lakshadweep,1982,51,1856,126,1856
06/03/2021,Lakshadweep,2078,96,1939,139,1939
07/03/2021,Lakshadweep,2078,0,1939,139,1939
08/03/2021,Lakshadweep,2310,232,2121,189,2121
09/03/2021,Lakshadweep,1667,-643,1452,215,1667
10/03/2021,Lakshadweep,1854,187,1535,319,1854
11/03/2021,Lakshadweep,2056,202,1589,467,2056
12/03/2021,Lakshadweep,2275,219,1605,670,2275
13/03/2021,Lakshadweep,2510,235,1657,853,2510
14/03/2021,Lakshadweep,2541,31,1659,882,2541
15/03/2021,Lakshadweep,2717,176,1727,990,2717
16/03/2021,Lakshadweep,3860,1143,2753,1107,2753
17/03/2021,Lakshadweep,4555,695,3420,1135,3420
18/03/2021,Lakshadweep,4904,349,3617,1287,3617
19/03/2021,Lakshadweep,5088,184,3735,1353,3735
20/03/2021,Lakshadweep,5387,299,3915,1472,3915
21/03/2021,Lakshadweep,5394,7,3920,1474,3920
22/03/2021,Lakshadweep,5521,127,4018,1503,4018
23/03/2021,Lakshadweep,5707,186,4145,1562,4145
24/03/2021,Lakshadweep,5826,119,4233,1593,4233
25/03/2021,Lakshadweep,5901,75,4277,1624,4277
26/03/2021,Lakshadweep,6053,152,4405,1648,4405
27/03/2021,Lakshadweep,6266,213,4601,1665,4601
28/03/2021,Lakshadweep,6333,67,4653,1680,4653
29/03/2021,Lakshadweep,6333,0,4653,1680,4653
30/03/2021,Lakshadweep,6552,219,4804,1748,4804
31/03/2021,Lakshadweep,6824,272,5034,1790,5034
01/04/2021,Lakshadweep,6953,129,5156,1797,5156
02/04/2021,Lakshadweep,7168,215,5365,1803,5365
03/04/2021,Lakshadweep,7399,231,5578,1821,5578
04/04/2021,Lakshadweep,7746,347,5912,1834,5912
05/04/2021,Lakshadweep,7993,247,6130,1863,6130
06/04/2021,Lakshadweep,8434,441,6501,1933,6501
07/04/2021,Lakshadweep,9484,1050,7379,2105,7379
08/04/2021,Lakshadweep,10621,1137,8312,2309,8312
09/04/2021,Lakshadweep,11527,906,9063,2464,9063
10/04/2021,Lakshadweep,12707,1180,10150,2557,10150
11/04/2021,Lakshadweep,13223,516,10630,2593,10630
12/04/2021,Lakshadweep,13791,568,11139,2652,11139
13/04/2021,Lakshadweep,14389,598,11691,2698,11691
14/04/2021,Lakshadweep,15275,886,12470,2805,12470
15/04/2021,Lakshadweep,16053,778,13174,2879,13174
16/04/2021,Lakshadweep,16446,393,13529,2917,13529
17/04/2021,Lakshadweep,17145,699,14161,2984,14161
18/04/2021,Lakshadweep,18013,868,14933,3080,14933
19/04/2021,Lakshadweep,18439,426,15300,3139,15300
20/04/2021,Lakshadweep,18894,455,15609,3285,15609
21/04/2021,Lakshadweep,19750,856,16225,3525,16225
22/04/2021,Lakshadweep,20140,390,16523,3617,16523
23/04/2021,Lakshadweep,20544,404,16836,3708,16836
24/04/2021,Lakshadweep,21022,478,17253,3769,17253
25/04/2021,Lakshadweep,21363,341,17538,3825,17538
26/04/2021,Lakshadweep,21732,369,17843,3889,17843
27/04/2021,Lakshadweep,21928,196,17998,3930,17998
28/04/2021,Lakshadweep,22090,162,18120,3970,18120
29/04/2021,Lakshadweep,22410,320,18386,4024,18386
30/04/2021,Lakshadweep,23024,614,18888,4136,18888
01/05/2021,Lakshadweep,23444,420,19170,4274,19170
02/05/2021,Lakshadweep,23634,190,19319,4315,19319
03/05/2021,Lakshadweep,23908,274,19460,4448,19460
04/05/2021,Lakshadweep,24226,318,19666,4560,19666
05/05/2021,Lakshadweep,24766,540,19872,4894,19872
06/05/2021,Lakshadweep,25040,274,19986,5054,19986
07/05/2021,Lakshadweep,25396,356,20131,5265,20131
08/05/2021,Lakshadweep,25693,297,20240,5453,20240
09/05/2021,Lakshadweep,25943,250,20307,5636,20307
10/05/2021,Lakshadweep,26489,546,20513,5976,20513
11/05/2021,Lakshadweep,27372,883,20885,6487,20885
12/05/2021,Lakshadweep,28102,730,21348,6754,21348
13/05/2021,Lakshadweep,28229,127,21428,6801,21428
14/05/2021,Lakshadweep,28241,12,21440,6801,21440
15/05/2021,Lakshadweep,28258,17,21452,6806,21452
16/05/2021,Lakshadweep,28282,24,21472,6810,21472
17/05/2021,Lakshadweep,28390,108,21562,6828,21562
18/05/2021,Lakshadweep,28703,313,21866,6837,21866
19/05/2021,Lakshadweep,28943,240,22086,6857,22086
20/05/2021,Lakshadweep,29039,96,22167,6872,22167
21/05/2021,Lakshadweep,29532,493,22620,6912,22620
22/05/2021,Lakshadweep,30027,495,23106,6921,23106
23/05/2021,Lakshadweep,30955,928,24029,6926,24029
24/05/2021,Lakshadweep,31277,322,24344,6933,24344
25/05/2021,Lakshadweep,31319,42,24384,6935,24384
26/05/2021,Lakshadweep,31381,62,24446,6935,24446
27/05/2021,Lakshadweep,31425,44,24487,6938,24487
28/05/2021,Lakshadweep,31668,243,24727,6941,24727
29/05/2021,Lakshadweep,32136,468,25192,6944,25192
30/05/2021,Lakshadweep,32818,682,25870,6948,25870
31/05/2021,Lakshadweep,33636,818,26687,6949,26687
01/06/2021,Lakshadweep,34439,803,27489,6950,27489
02/06/2021,Lakshadweep,35167,728,28215,6952,28215
03/06/2021,Lakshadweep,36206,1039,29251,6955,29251
04/06/2021,Lakshadweep,37342,1136,30378,6964,30378
05/06/2021,Lakshadweep,38294,952,31322,6972,31322
06/06/2021,Lakshadweep,39071,777,32096,6975,32096
07/06/2021,Lakshadweep,40301,1230,33318,6983,33318
08/06/2021,Lakshadweep,41455,1154,34466,6989,34466
09/06/2021,Lakshadweep,42665,1210,35632,7033,35632
10/06/2021,Lakshadweep,43565,900,36523,7042,36523
11/06/2021,Lakshadweep,44754,1189,37701,7053,37701
12/06/2021,Lakshadweep,46083,1329,39006,7077,39006
13/06/2021,Lakshadweep,46809,726,39722,7087,39722
14/06/2021,Lakshadweep,47816,1007,40722,7094,40722
15/06/2021,Lakshadweep,48599,783,41486,7113,41486
16/06/2021,Lakshadweep,49904,1305,42783,7121,42783
17/06/2021,Lakshadweep,50334,430,43210,7124,43210
18/06/2021,Lakshadweep,50773,439,43642,7131,43642
19/06/2021,Lakshadweep,51284,511,44126,7158,44126
20/06/2021,Lakshadweep,51507,223,44347,7160,44347
21/06/2021,Lakshadweep,52001,494,44826,7175,44826
22/06/2021,Lakshadweep,52459,458,45234,7225,45234
23/06/2021,Lakshadweep,52829,370,45566,7263,45566
24/06/2021,Lakshadweep,53150,321,45834,7316,45834
25/06/2021,Lakshadweep,53433,283,46057,7376,
26/06/2021,Lakshadweep,53736,303,46253,7483,
27/06/2021,Lakshadweep,53855,119,46340,7515,
28/06/2021,Lakshadweep,54138,283,46494,7644,
29/06/2021,Lakshadweep,54662,524,46750,7912,
30/06/2021,Lakshadweep,54700,38,46779,7921,
01/07/2021,Lakshadweep,54928,228,46901,8027,
02/07/2021,Lakshadweep,55294,366,47042,8252,
03/07/2021,Lakshadweep,55632,338,47084,8548,
04/07/2021,Lakshadweep,55674,42,47084,8590,
05/07/2021,Lakshadweep,56206,532,47243,8963,
06/07/2021,Lakshadweep,56755,549,47468,9287,
07/07/2021,Lakshadweep,57324,569,47562,9762,
08/07/2021,Lakshadweep,57844,520,47717,10127,
09/07/2021,Lakshadweep,58285,441,47830,10455,
10/07/2021,Lakshadweep,58606,321,47936,10670,
11/07/2021,Lakshadweep,58734,128,47993,10741,
12/07/2021,Lakshadweep,59081,347,48058,11023,
13/07/2021,Lakshadweep,59657,576,48155,11502,
14/07/2021,Lakshadweep,60568,911,48684,11884,
15/07/2021,Lakshadweep,61144,576,48780,12364,
16/07/2021,Lakshadweep,61637,493,48893,12744,
17/07/2021,Lakshadweep,61956,319,48946,13010,
18/07/2021,Lakshadweep,62021,65,49004,13017,
19/07/2021,Lakshadweep,62346,325,49064,13282,
20/07/2021,Lakshadweep,62715,369,49196,13519,
21/07/2021,Lakshadweep,62989,274,49276,13713,
22/07/2021,Lakshadweep,63093,104,49304,13789,
23/07/2021,Lakshadweep,63558,465,49479,14079,
24/07/2021,Lakshadweep,64080,522,49638,14442,
25/07/2021,Lakshadweep,64116,36,49661,14455,
26/07/2021,Lakshadweep,64502,386,49794,14708,
27/07/2021,Lakshadweep,65060,558,49949,15111,
28/07/2021,Lakshadweep,65418,358,50017,15401,
29/07/2021,Lakshadweep,65707,289,50094,15613,
30/07/2021,Lakshadweep,65988,281,50168,15820,
31/07/2021,Lakshadweep,66209,221,50238,15971,
01/08/2021,Lakshadweep,66406,197,50405,16001,
02/08/2021,Lakshadweep,66642,236,50484,16158,
03/08/2021,Lakshadweep,66762,120,50511,16251,
04/08/2021,Lakshadweep,67032,270,50596,16436,
05/08/2021,Lakshadweep,67253,221,50668,16585,
06/08/2021,Lakshadweep,67491,238,50772,16719,
07/08/2021,Lakshadweep,67712,221,50851,16861,
08/08/2021,Lakshadweep,67913,201,50962,16951,
09/08/2021,Lakshadweep,68295,382,51156,17139,
,,,,,,
,,,,,,
,,,,,,
,,,,,,
,,,,,,
,,,,,,
16/01/2021,Madhya Pradesh,9435,9435,9435,0,9435
17/01/2021,Madhya Pradesh,9435,0,9435,0,9435
18/01/2021,Madhya Pradesh,15934,6499,15934,0,15934
19/01/2021,Madhya Pradesh,18409,2475,18409,0,18409
20/01/2021,Madhya Pradesh,27769,9360,27769,0,27769
21/01/2021,Madhya Pradesh,38425,10656,38425,0,38425
22/01/2021,Madhya Pradesh,38425,0,38425,0,38425
23/01/2021,Madhya Pradesh,38428,3,38428,0,38428
24/01/2021,Madhya Pradesh,38430,2,38430,0,38430
25/01/2021,Madhya Pradesh,66875,28445,66875,0,66875
26/01/2021,Madhya Pradesh,66877,2,66877,0,66877
27/01/2021,Madhya Pradesh,131099,64222,131099,0,131099
28/01/2021,Madhya Pradesh,192628,61529,192628,0,192628
29/01/2021,Madhya Pradesh,234631,42003,234631,0,234631
30/01/2021,Madhya Pradesh,284782,50151,284782,0,284782
31/01/2021,Madhya Pradesh,285481,699,285481,0,285481
01/02/2021,Madhya Pradesh,286538,1057,286538,0,286538
02/02/2021,Madhya Pradesh,286868,330,286868,0,286868
03/02/2021,Madhya Pradesh,319623,32755,319623,0,319623
04/02/2021,Madhya Pradesh,329571,9948,329571,0,329571
05/02/2021,Madhya Pradesh,331316,1745,331316,0,331316
06/02/2021,Madhya Pradesh,332832,1516,332832,0,332832
07/02/2021,Madhya Pradesh,333677,845,333677,0,333677
08/02/2021,Madhya Pradesh,369141,35464,369141,0,369141
09/02/2021,Madhya Pradesh,373504,4363,373504,0,373504
10/02/2021,Madhya Pradesh,427715,54211,427715,0,427715
11/02/2021,Madhya Pradesh,482095,54380,482095,0,482095
12/02/2021,Madhya Pradesh,519589,37494,519589,0,519589
13/02/2021,Madhya Pradesh,548275,28686,548272,3,548272
14/02/2021,Madhya Pradesh,548469,194,548466,3,548466
15/02/2021,Madhya Pradesh,565957,17488,565952,5,565952
16/02/2021,Madhya Pradesh,567591,1634,567586,5,567586
17/02/2021,Madhya Pradesh,587658,20067,587652,6,587652
18/02/2021,Madhya Pradesh,598328,10670,598319,9,598319
19/02/2021,Madhya Pradesh,616805,18477,616782,23,616782
20/02/2021,Madhya Pradesh,635446,18641,631637,3809,631637
21/02/2021,Madhya Pradesh,636057,611,632248,3809,632248
22/02/2021,Madhya Pradesh,666759,30702,635089,31670,635089
23/02/2021,Madhya Pradesh,668773,2014,636139,32634,636139
24/02/2021,Madhya Pradesh,716682,47909,639425,77257,639425
25/02/2021,Madhya Pradesh,773228,56546,642871,130357,642871
26/02/2021,Madhya Pradesh,804378,31150,644716,159662,644716
27/02/2021,Madhya Pradesh,804378,0,644716,159662,644716
28/02/2021,Madhya Pradesh,804378,0,644716,159662,644716
01/03/2021,Madhya Pradesh,804378,0,644716,159662,644716
02/03/2021,Madhya Pradesh,846487,42109,664726,181761,664726
03/03/2021,Madhya Pradesh,908051,61564,706334,201717,706334
04/03/2021,Madhya Pradesh,970531,62480,754152,216379,754152
05/03/2021,Madhya Pradesh,978701,8170,760376,218325,760376
06/03/2021,Madhya Pradesh,1049846,71145,817810,232036,817810
07/03/2021,Madhya Pradesh,1052103,2257,819884,232219,819884
08/03/2021,Madhya Pradesh,1123372,71269,878269,245103,878269
09/03/2021,Madhya Pradesh,894175,-229197,648495,245680,894175
10/03/2021,Madhya Pradesh,982005,87830,703816,278189,982005
11/03/2021,Madhya Pradesh,983629,1624,704997,278632,983629
12/03/2021,Madhya Pradesh,989013,5384,708872,280141,989013
13/03/2021,Madhya Pradesh,1147591,158578,812922,334669,1147591
14/03/2021,Madhya Pradesh,1149813,2222,814865,334948,1149813
15/03/2021,Madhya Pradesh,1311000,161187,935527,375473,1311000
16/03/2021,Madhya Pradesh,1582017,271017,1204532,377485,1204532
17/03/2021,Madhya Pradesh,1894779,312762,1483101,411678,1483101
18/03/2021,Madhya Pradesh,2061982,167203,1630087,431895,1630087
19/03/2021,Madhya Pradesh,2082196,20214,1648828,433368,1648828
20/03/2021,Madhya Pradesh,2392868,310672,1936427,456441,1936427
21/03/2021,Madhya Pradesh,2447794,54926,1988398,459396,1988398
22/03/2021,Madhya Pradesh,2645609,197815,2173688,471921,2173688
23/03/2021,Madhya Pradesh,2709136,63527,2233935,475201,2233935
24/03/2021,Madhya Pradesh,2970294,261158,2484618,485676,2484618
25/03/2021,Madhya Pradesh,3117583,147289,2625418,492165,2625418
26/03/2021,Madhya Pradesh,3124997,7414,2632468,492529,2632468
27/03/2021,Madhya Pradesh,3235027,110030,2737954,497073,2737954
28/03/2021,Madhya Pradesh,3238287,3260,2740984,497303,2740984
29/03/2021,Madhya Pradesh,3238300,13,2740995,497305,2740995
30/03/2021,Madhya Pradesh,3241368,3068,2743883,497485,2743883
31/03/2021,Madhya Pradesh,3399721,158353,2890848,508873,2890848
01/04/2021,Madhya Pradesh,3632471,232750,3115146,517325,3115146
02/04/2021,Madhya Pradesh,3871927,239456,3346831,525096,3346831
03/04/2021,Madhya Pradesh,4043380,171453,3510799,532581,3510799
04/04/2021,Madhya Pradesh,4214544,171164,3675945,538599,3675945
05/04/2021,Madhya Pradesh,4376033,161489,3831368,544665,3831368
06/04/2021,Madhya Pradesh,4528210,152177,3977455,550755,3977455
07/04/2021,Madhya Pradesh,4902462,374252,4334898,567564,4334898
08/04/2021,Madhya Pradesh,5233168,330706,4649680,583488,4649680
09/04/2021,Madhya Pradesh,5361979,128811,4770269,591710,4770269
10/04/2021,Madhya Pradesh,5464925,102946,4866494,598431,4866494
11/04/2021,Madhya Pradesh,5837149,372224,5222120,615029,5222120
12/04/2021,Madhya Pradesh,6244525,407376,5603174,641351,5603174
13/04/2021,Madhya Pradesh,6558169,313644,5899933,658236,5899933
14/04/2021,Madhya Pradesh,6886916,328747,6202259,684657,6202259
15/04/2021,Madhya Pradesh,7057160,170244,6348519,708641,6348519
16/04/2021,Madhya Pradesh,7115632,58472,6392872,722760,6392872
17/04/2021,Madhya Pradesh,7304172,188540,6546917,757255,6546917
18/04/2021,Madhya Pradesh,7329797,25625,6566352,763445,6566352
19/04/2021,Madhya Pradesh,7506383,176586,6700964,805419,6700964
20/04/2021,Madhya Pradesh,7542919,36536,6725608,817311,6725608
21/04/2021,Madhya Pradesh,7566279,23360,6737838,828441,6737838
22/04/2021,Madhya Pradesh,7736804,170525,6850130,886674,6850130
23/04/2021,Madhya Pradesh,7774354,37550,6871962,902392,6871962
24/04/2021,Madhya Pradesh,7895385,121031,6942784,952601,6942784
25/04/2021,Madhya Pradesh,7908711,13326,6949787,958924,6949787
26/04/2021,Madhya Pradesh,7991537,82826,6988355,1003182,6988355
27/04/2021,Madhya Pradesh,8010474,18937,6996487,1013987,6996487
28/04/2021,Madhya Pradesh,8071696,61222,7020074,1051622,7020074
29/04/2021,Madhya Pradesh,8077002,5306,7022419,1054583,7022419
30/04/2021,Madhya Pradesh,8079538,2536,7023042,1056496,7023042
01/05/2021,Madhya Pradesh,8147203,67665,7043286,1103917,7043286
02/05/2021,Madhya Pradesh,8154964,7761,7046019,1108945,7046019
03/05/2021,Madhya Pradesh,8228404,73440,7065585,1162819,7065585
04/05/2021,Madhya Pradesh,8249533,21129,7071530,1178003,7071530
05/05/2021,Madhya Pradesh,8380264,130731,7110730,1269534,7110730
06/05/2021,Madhya Pradesh,8490151,109887,7146019,1344132,7146019
07/05/2021,Madhya Pradesh,8508272,18121,7151755,1356517,7151755
08/05/2021,Madhya Pradesh,8634077,125805,7201637,1432440,7201637
09/05/2021,Madhya Pradesh,8636212,2135,7202462,1433750,7202462
10/05/2021,Madhya Pradesh,8765843,129631,7251862,1513981,7251862
11/05/2021,Madhya Pradesh,8785173,19330,7256989,1528184,7256989
12/05/2021,Madhya Pradesh,8923121,137948,7335386,1587735,7335386
13/05/2021,Madhya Pradesh,9034702,111581,7402933,1631769,7402933
14/05/2021,Madhya Pradesh,9037120,2418,7403682,1633438,7403682
15/05/2021,Madhya Pradesh,9163547,126427,7472841,1690706,7472841
16/05/2021,Madhya Pradesh,9164574,1027,7473284,1691290,7473284
17/05/2021,Madhya Pradesh,9258467,93893,7547349,1711118,7547349
18/05/2021,Madhya Pradesh,9264811,6344,7551243,1713568,7551243
19/05/2021,Madhya Pradesh,9405542,140731,7678925,1726617,7678925
20/05/2021,Madhya Pradesh,9534535,128993,7798981,1735554,7798981
21/05/2021,Madhya Pradesh,9633945,99410,7890673,1743272,7890673
22/05/2021,Madhya Pradesh,9780866,146921,8027748,1753118,8027748
23/05/2021,Madhya Pradesh,9951903,171037,8197098,1754805,8197098
24/05/2021,Madhya Pradesh,10169757,217854,8407255,1762502,8407255
25/05/2021,Madhya Pradesh,10176369,6612,8412889,1763480,8412889
26/05/2021,Madhya Pradesh,10178601,2232,8415023,1763578,8415023
27/05/2021,Madhya Pradesh,10408718,230117,8636592,1772126,8636592
28/05/2021,Madhya Pradesh,10632295,223577,8854635,1777660,8854635
29/05/2021,Madhya Pradesh,10882668,250373,9098436,1784232,9098436
30/05/2021,Madhya Pradesh,10899947,17279,9115504,1784443,9115504
31/05/2021,Madhya Pradesh,11170319,270372,9378050,1792269,9378050
01/06/2021,Madhya Pradesh,11188263,17944,9394692,1793571,9394692
02/06/2021,Madhya Pradesh,11481427,293164,9680087,1801340,9680087
03/06/2021,Madhya Pradesh,11853494,372067,10041226,1812268,10041226
04/06/2021,Madhya Pradesh,12217489,363995,10399189,1818300,10399189
05/06/2021,Madhya Pradesh,12629509,412020,10796888,1832621,10796888
06/06/2021,Madhya Pradesh,12759138,129629,10923948,1835190,10923948
07/06/2021,Madhya Pradesh,13151267,392129,11299196,1852071,11299196
08/06/2021,Madhya Pradesh,13217372,66105,11361743,1855629,11361743
09/06/2021,Madhya Pradesh,13584232,366860,11708227,1876005,11708227
10/06/2021,Madhya Pradesh,13769115,184883,11877371,1891744,11877371
11/06/2021,Madhya Pradesh,13796834,27719,11899138,1897696,11899138
12/06/2021,Madhya Pradesh,13897841,101007,11956103,1941738,11956103
13/06/2021,Madhya Pradesh,13943751,45910,11992799,1950952,11992799
14/06/2021,Madhya Pradesh,14443636,499885,12452440,1991196,12452440
15/06/2021,Madhya Pradesh,14495499,51863,12497943,1997556,12497943
16/06/2021,Madhya Pradesh,14840484,344985,12815277,2025207,12815277
17/06/2021,Madhya Pradesh,14975268,134784,12934175,2041093,12934175
18/06/2021,Madhya Pradesh,14994833,19565,12950585,2044248,12950585
19/06/2021,Madhya Pradesh,15018743,23910,12964134,2054609,12964134
20/06/2021,Madhya Pradesh,15019817,1074,12965037,2054780,12965037
21/06/2021,Madhya Pradesh,16733198,1713381,14594389,2138809,14594389
22/06/2021,Madhya Pradesh,16803173,69975,14660585,2142588,14660585
23/06/2021,Madhya Pradesh,17978981,1175808,15775623,2203358,15775623
24/06/2021,Madhya Pradesh,18769872,790891,16512594,2257278,16512594
25/06/2021,Madhya Pradesh,18801044,31172,16543406,2257638,
26/06/2021,Madhya Pradesh,19801236,1000192,17444479,2356757,
27/06/2021,Madhya Pradesh,19826706,25470,17466782,2359924,
28/06/2021,Madhya Pradesh,20289692,462986,17897347,2392345,
29/06/2021,Madhya Pradesh,20303352,13660,17909367,2393985,
30/06/2021,Madhya Pradesh,20314158,10806,17917782,2396376,
01/07/2021,Madhya Pradesh,21302275,988117,18757527,2544748,
02/07/2021,Madhya Pradesh,21326909,24634,18778322,2548587,
03/07/2021,Madhya Pradesh,21594951,268042,18782476,2812475,
04/07/2021,Madhya Pradesh,21602436,7485,18783420,2819016,
05/07/2021,Madhya Pradesh,22016213,413777,18788825,3227388,
06/07/2021,Madhya Pradesh,22028495,12282,18792034,3236461,
07/07/2021,Madhya Pradesh,22486768,458273,18987978,3498790,
08/07/2021,Madhya Pradesh,23209424,722656,19540483,3668941,
09/07/2021,Madhya Pradesh,23229284,19860,19555644,3673640,
10/07/2021,Madhya Pradesh,23916986,687702,20128154,3788832,
11/07/2021,Madhya Pradesh,23934917,17931,20143867,3791050,
12/07/2021,Madhya Pradesh,23973478,38561,20157496,3815982,
13/07/2021,Madhya Pradesh,23977911,4433,20160054,3817857,
14/07/2021,Madhya Pradesh,24566317,588406,20652966,3913351,
15/07/2021,Madhya Pradesh,25015501,449184,21028776,3986725,
16/07/2021,Madhya Pradesh,25028056,12555,21039211,3988845,
17/07/2021,Madhya Pradesh,25182121,154065,21168157,4013964,
18/07/2021,Madhya Pradesh,25192158,10037,21176794,4015364,
19/07/2021,Madhya Pradesh,25678516,486358,21551160,4127356,
20/07/2021,Madhya Pradesh,25692342,13826,21562031,4130311,
21/07/2021,Madhya Pradesh,25695476,3134,21563261,4132215,
22/07/2021,Madhya Pradesh,26791031,1095555,22431445,4359586,
23/07/2021,Madhya Pradesh,26859236,68205,22489547,4369689,
24/07/2021,Madhya Pradesh,27835437,976201,23287139,4548298,
25/07/2021,Madhya Pradesh,27868363,32926,23316206,4552157,
26/07/2021,Madhya Pradesh,29006804,1138441,24275999,4730805,
27/07/2021,Madhya Pradesh,29072338,65534,24331336,4741002,
28/07/2021,Madhya Pradesh,30150558,1078220,25242266,4908292,
29/07/2021,Madhya Pradesh,30906116,755558,25904540,5001576,
30/07/2021,Madhya Pradesh,30970799,64683,25959893,5010906,
31/07/2021,Madhya Pradesh,31999209,1028410,26830212,5168997,
01/08/2021,Madhya Pradesh,32227488,228279,27049238,5178250,
02/08/2021,Madhya Pradesh,33045723,818235,27755842,5289881,
03/08/2021,Madhya Pradesh,33169564,123841,27866204,5303360,
04/08/2021,Madhya Pradesh,33697618,528054,28297794,5399824,
05/08/2021,Madhya Pradesh,34156553,458935,28647319,5509234,
06/08/2021,Madhya Pradesh,34238857,82304,28719618,5519239,
07/08/2021,Madhya Pradesh,34853048,614191,29211273,5641775,
08/08/2021,Madhya Pradesh,34901221,48173,29251571,5649650,
09/08/2021,Madhya Pradesh,35456676,555455,29723036,5733640,
,,,,,,
,,,,,,
,,,,,,
,,,,,,
,,,,,,
,,,,,,
16/01/2021,Maharashtra,5726,5726,5726,0,5726
17/01/2021,Maharashtra,6521,795,6521,0,6521
18/01/2021,Maharashtra,6151,-370,6151,0,6151
19/01/2021,Maharashtra,13699,7548,13699,0,13699
20/01/2021,Maharashtra,23880,10181,23880,0,23880
21/01/2021,Maharashtra,24148,268,24148,0,24148
22/01/2021,Maharashtra,44369,20221,44369,0,44369
23/01/2021,Maharashtra,69295,24926,69295,0,69295
24/01/2021,Maharashtra,70196,901,70196,0,70196
25/01/2021,Maharashtra,107073,36877,107073,0,107073
26/01/2021,Maharashtra,107338,265,107338,0,107338
27/01/2021,Maharashtra,150102,42764,150102,0,150102
28/01/2021,Maharashtra,189743,39641,189743,0,189743
29/01/2021,Maharashtra,225132,35389,225132,0,225132
30/01/2021,Maharashtra,233693,8561,233693,0,233693
31/01/2021,Maharashtra,234150,457,234150,0,234150
01/02/2021,Maharashtra,275348,41198,275348,0,275348
02/02/2021,Maharashtra,284107,8759,284107,0,284107
03/02/2021,Maharashtra,318918,34811,318918,0,318918
04/02/2021,Maharashtra,352676,33758,352676,0,352676
05/02/2021,Maharashtra,397889,45213,397889,0,397889
06/02/2021,Maharashtra,436229,38340,436229,0,436229
07/02/2021,Maharashtra,436400,171,436400,0,436400
08/02/2021,Maharashtra,475193,38793,475193,0,475193
09/02/2021,Maharashtra,503757,28564,503757,0,503757
10/02/2021,Maharashtra,544726,40969,544726,0,544726
11/02/2021,Maharashtra,579241,34515,579241,0,579241
12/02/2021,Maharashtra,620539,41298,620539,0,620539
13/02/2021,Maharashtra,652971,32432,652801,170,652801
14/02/2021,Maharashtra,653305,334,653135,170,653135
15/02/2021,Maharashtra,687137,33832,682610,4527,682610
16/02/2021,Maharashtra,719944,32807,711043,8901,711043
17/02/2021,Maharashtra,768695,48751,752088,16607,752088
18/02/2021,Maharashtra,810906,42211,787086,23820,787086
19/02/2021,Maharashtra,853374,42468,825846,27528,825846
20/02/2021,Maharashtra,913658,60284,868244,45414,868244
21/02/2021,Maharashtra,917962,4304,871567,46395,871567
22/02/2021,Maharashtra,975061,57099,907200,67861,907200
23/02/2021,Maharashtra,1017414,42353,938078,79336,938078
24/02/2021,Maharashtra,1073789,56375,969314,104475,969314
25/02/2021,Maharashtra,1128081,54292,997308,130773,997308
26/02/2021,Maharashtra,1187018,58937,1028360,158658,1028360
27/02/2021,Maharashtra,1187023,5,1028365,158658,1028365
28/02/2021,Maharashtra,1187178,155,1028520,158658,1028520
01/03/2021,Maharashtra,1187178,0,1028520,158658,1028520
02/03/2021,Maharashtra,1251419,64241,1071612,179807,1071612
03/03/2021,Maharashtra,1317336,65917,1119835,197501,1119835
04/03/2021,Maharashtra,1387989,70653,1174258,213731,1174258
05/03/2021,Maharashtra,1479034,91045,1244617,234417,1244617
06/03/2021,Maharashtra,1584841,105807,1325264,259577,1325264
07/03/2021,Maharashtra,1591448,6607,1331000,260448,1331000
08/03/2021,Maharashtra,1739823,148375,1454112,285711,1454112
09/03/2021,Maharashtra,1572965,-166858,1267076,305889,1572965
10/03/2021,Maharashtra,1749221,176256,1410564,338657,1749221
11/03/2021,Maharashtra,1804254,55033,1455521,348733,1804254
12/03/2021,Maharashtra,1996304,192050,1612991,383313,1996304
13/03/2021,Maharashtra,2125486,129182,1713932,411554,2125486
14/03/2021,Maharashtra,2132670,7184,1720591,412079,2132670
15/03/2021,Maharashtra,2342873,210203,1898597,444276,2342873
16/03/2021,Maharashtra,2785457,442584,2316957,468500,2316957
17/03/2021,Maharashtra,3729963,944506,3229723,500240,3229723
18/03/2021,Maharashtra,3933965,204002,3408977,524988,3408977
19/03/2021,Maharashtra,4178758,244793,3622709,556049,3622709
20/03/2021,Maharashtra,4404844,226086,3815920,588924,3815920
21/03/2021,Maharashtra,4440954,36110,3847301,593653,3847301
22/03/2021,Maharashtra,4682864,241910,4060919,621945,4060919
23/03/2021,Maharashtra,4911726,228862,4262362,649364,4262362
24/03/2021,Maharashtra,5164217,252491,4494807,669410,4494807
25/03/2021,Maharashtra,5386656,222439,4701964,684692,4701964
26/03/2021,Maharashtra,5648523,261867,4944116,704407,4944116
27/03/2021,Maharashtra,5881573,233050,5163746,717827,5163746
28/03/2021,Maharashtra,5902265,20692,5183711,718554,5183711
29/03/2021,Maharashtra,5956802,54537,5235606,721196,5235606
30/03/2021,Maharashtra,6156334,199532,5421876,734458,5421876
31/03/2021,Maharashtra,6370261,213927,5618555,751706,5618555
01/04/2021,Maharashtra,6596079,225818,5833743,762336,5833743
02/04/2021,Maharashtra,6960404,364325,6182629,777775,6182629
03/04/2021,Maharashtra,7288572,328168,6496037,792535,6496037
04/04/2021,Maharashtra,7647126,358554,6841397,805729,6841397
05/04/2021,Maharashtra,7989165,342039,7167016,822149,7167016
06/04/2021,Maharashtra,8257040,267875,7421245,835795,7421245
07/04/2021,Maharashtra,8856664,599624,7988151,868513,7988151
08/04/2021,Maharashtra,9337790,481126,8434286,903504,8434286
09/04/2021,Maharashtra,9632399,294609,8702273,930126,8702273
10/04/2021,Maharashtra,9923253,290854,8969876,953377,8969876
11/04/2021,Maharashtra,10191896,268643,9220161,971735,9220161
12/04/2021,Maharashtra,10528419,336523,9519815,1008604,9519815
13/04/2021,Maharashtra,10753451,225032,9717561,1035890,9717561
14/04/2021,Maharashtra,11124975,371524,10038913,1086062,10038913
15/04/2021,Maharashtra,11511023,386048,10356338,1154685,10356338
16/04/2021,Maharashtra,11885830,374807,10658902,1226928,10658902
17/04/2021,Maharashtra,12138971,253141,10849828,1289143,10849828
18/04/2021,Maharashtra,12273763,134792,10959390,1314373,10959390
19/04/2021,Maharashtra,12649330,375567,11240031,1409299,11240031
20/04/2021,Maharashtra,12944719,295389,11447258,1497461,11447258
21/04/2021,Maharashtra,13279389,334670,11691829,1587560,11691829
22/04/2021,Maharashtra,13673833,394444,11966150,1707683,11966150
23/04/2021,Maharashtra,13999938,326105,12184886,1815052,12184886
24/04/2021,Maharashtra,14229977,230039,12326873,1903104,12326873
25/04/2021,Maharashtra,14342185,112208,12404273,1937912,12404273
26/04/2021,Maharashtra,14905825,563640,12768316,2137509,12768316
27/04/2021,Maharashtra,15321730,415905,13030894,2290836,13030894
28/04/2021,Maharashtra,15577636,255906,13184469,2393167,13184469
29/04/2021,Maharashtra,15870448,292812,13360080,2510368,13360080
30/04/2021,Maharashtra,16183847,313399,13561437,2622410,13561437
01/05/2021,Maharashtra,16292753,108906,13637082,2655671,13637082
02/05/2021,Maharashtra,16342814,50061,13677591,2665223,13677591
03/05/2021,Maharashtra,16425887,83073,13739753,2686134,13739753
04/05/2021,Maharashtra,16528345,102458,13799328,2729017,13799328
05/05/2021,Maharashtra,16802255,273910,13935541,2866714,13935541
06/05/2021,Maharashtra,17296109,493854,14214775,3081334,14214775
07/05/2021,Maharashtra,17693374,397265,14458039,3235335,14458039
08/05/2021,Maharashtra,17947420,254046,14628881,3318539,14628881
09/05/2021,Maharashtra,18063345,115925,14712246,3351099,14712246
10/05/2021,Maharashtra,18380699,317354,14888694,3492005,14888694
11/05/2021,Maharashtra,18793256,412557,15144171,3649085,15144171
12/05/2021,Maharashtra,19139375,346119,15322754,3816621,15322754
13/05/2021,Maharashtra,19530640,391265,15499282,4031358,15499282
14/05/2021,Maharashtra,19703138,172498,15571915,4131223,15571915
15/05/2021,Maharashtra,19912961,209823,15706411,4206550,15706411
16/05/2021,Maharashtra,19985484,72523,15756833,4228651,15756833
17/05/2021,Maharashtra,20090425,104941,15833287,4257138,15833287
18/05/2021,Maharashtra,20201111,110686,15923242,4277869,15923242
19/05/2021,Maharashtra,20305921,104810,16000236,4305685,16000236
20/05/2021,Maharashtra,20469090,163169,16125493,4343597,16125493
21/05/2021,Maharashtra,20594537,125447,16228164,4366373,16228164
22/05/2021,Maharashtra,20721982,127445,16334126,4387856,16334126
23/05/2021,Maharashtra,20764364,42382,16372676,4391688,16372676
24/05/2021,Maharashtra,21017944,253580,16609722,4408222,16609722
25/05/2021,Maharashtra,21218705,200761,16796171,4422534,16796171
26/05/2021,Maharashtra,21357076,138371,16923391,4433685,16923391
27/05/2021,Maharashtra,21646104,289028,17185317,4460787,17185317
28/05/2021,Maharashtra,21922389,276285,17435219,4487170,17435219
29/05/2021,Maharashtra,22230988,308599,17709573,4521415,17709573
30/05/2021,Maharashtra,22319656,88668,17787436,4532220,17787436
31/05/2021,Maharashtra,22586620,266964,18016877,4569743,18016877
01/06/2021,Maharashtra,22850264,263644,18233839,4616425,18233839
02/06/2021,Maharashtra,23077246,226982,18425383,4651863,18425383
03/06/2021,Maharashtra,23302845,225599,18623132,4679713,18623132
04/06/2021,Maharashtra,23687499,384654,18959397,4728102,18959397
05/06/2021,Maharashtra,24049547,362048,19278027,4771520,19278027
06/06/2021,Maharashtra,24145432,95885,19360252,4785180,19360252
07/06/2021,Maharashtra,24450364,304932,19597498,4852866,19597498
08/06/2021,Maharashtra,24728789,278425,19794750,4934039,19794750
09/06/2021,Maharashtra,25042464,313675,20032402,5010062,20032402
10/06/2021,Maharashtra,25300779,258315,20232933,5067846,20232933
11/06/2021,Maharashtra,25560781,260002,20443246,5117535,20443246
12/06/2021,Maharashtra,25866677,305896,20693716,5172961,20693716
13/06/2021,Maharashtra,25958370,91693,20775032,5183338,20775032
14/06/2021,Maharashtra,26263095,304725,21027493,5235602,21027493
15/06/2021,Maharashtra,26524389,261294,21239855,5284534,21239855
16/06/2021,Maharashtra,26774547,250158,21442311,5332236,21442311
17/06/2021,Maharashtra,26985938,211391,21609227,5376711,21609227
18/06/2021,Maharashtra,27220156,234218,21802528,5417628,21802528
19/06/2021,Maharashtra,27616708,396552,22134489,5482219,22134489
20/06/2021,Maharashtra,27733974,117266,22244712,5489262,22244712
21/06/2021,Maharashtra,28128768,394794,22587693,5541075,22587693
22/06/2021,Maharashtra,28706375,577607,23089545,5616830,23089545
23/06/2021,Maharashtra,29345261,638886,23663198,5682063,23663198
24/06/2021,Maharashtra,29788061,442800,24046509,5741552,24046509
25/06/2021,Maharashtra,30283190,495129,24455767,5827423,
26/06/2021,Maharashtra,31032178,748988,25046626,5985552,
27/06/2021,Maharashtra,31158987,126809,25144877,6014110,
28/06/2021,Maharashtra,31781730,622743,25598367,6183363,
29/06/2021,Maharashtra,32178658,396928,25883793,6294865,
30/06/2021,Maharashtra,32439568,260910,26067743,6371825,
01/07/2021,Maharashtra,32720630,281062,26252541,6468089,
02/07/2021,Maharashtra,33109808,389178,26512487,6597321,
03/07/2021,Maharashtra,33928829,819021,27072332,6856497,
04/07/2021,Maharashtra,34076028,147199,27181244,6894784,
05/07/2021,Maharashtra,34404490,328462,27418175,6986315,
06/07/2021,Maharashtra,34802542,398052,27659911,7142631,
07/07/2021,Maharashtra,35444489,641947,28046480,7398009,
08/07/2021,Maharashtra,35772811,328322,28250166,7522645,
09/07/2021,Maharashtra,35975179,202368,28386677,7588502,
10/07/2021,Maharashtra,36344221,369042,28600239,7743982,
11/07/2021,Maharashtra,36525862,181641,28703462,7822400,
12/07/2021,Maharashtra,37024077,498215,28982004,8042073,
13/07/2021,Maharashtra,37296249,272172,29129845,8166404,
14/07/2021,Maharashtra,37924042,627793,29557531,8366511,
15/07/2021,Maharashtra,38267995,343953,29723209,8544786,
16/07/2021,Maharashtra,38894689,626694,30053289,8841400,
17/07/2021,Maharashtra,39381845,487156,30339078,9042767,
18/07/2021,Maharashtra,39513058,131213,30417030,9096028,
19/07/2021,Maharashtra,39911420,398362,30636226,9275194,
20/07/2021,Maharashtra,40107948,196528,30751876,9356072,
21/07/2021,Maharashtra,40217450,109502,30819326,9398124,
22/07/2021,Maharashtra,40420907,203457,30922026,9498881,
23/07/2021,Maharashtra,40855519,434612,31159841,9695678,
24/07/2021,Maharashtra,41200346,344827,31356540,9843806,
25/07/2021,Maharashtra,41318461,118115,31424845,9893616,
26/07/2021,Maharashtra,41768947,450486,31668541,10100406,
27/07/2021,Maharashtra,42352271,583324,31989528,10362743,
28/07/2021,Maharashtra,42707317,355046,32189240,10518077,
29/07/2021,Maharashtra,43082312,374995,32393868,10688444,
30/07/2021,Maharashtra,43764145,681833,32792777,10971368,
31/07/2021,Maharashtra,44359603,595458,33167633,11191970,
01/08/2021,Maharashtra,44671062,311459,33439833,11231229,
02/08/2021,Maharashtra,45003338,332276,33649689,11353649,
03/08/2021,Maharashtra,45244512,241174,33795497,11449015,
04/08/2021,Maharashtra,45474724,230212,33939493,11535231,
05/08/2021,Maharashtra,45992850,518126,34253740,11739110,
06/08/2021,Maharashtra,46376671,383821,34530607,11846064,
07/08/2021,Maharashtra,46685972,309301,34738768,11947204,
08/08/2021,Maharashtra,46758590,72618,34789759,11968831,
09/08/2021,Maharashtra,47153366,394776,35040812,12112554,
,,,,,,
,,,,,,
,,,,,,
,,,,,,
,,,,,,
,,,,,,
16/01/2021,Manipur,181,181,181,0,181
17/01/2021,Manipur,192,11,192,0,192
18/01/2021,Manipur,169,-23,169,0,169
19/01/2021,Manipur,267,98,267,0,267
20/01/2021,Manipur,426,159,426,0,426
21/01/2021,Manipur,426,0,426,0,426
22/01/2021,Manipur,693,267,693,0,693
23/01/2021,Manipur,1097,404,1097,0,1097
24/01/2021,Manipur,1109,12,1109,0,1109
25/01/2021,Manipur,1319,210,1319,0,1319
26/01/2021,Manipur,1328,9,1328,0,1328
27/01/2021,Manipur,1873,545,1873,0,1873
28/01/2021,Manipur,1909,36,1909,0,1909
29/01/2021,Manipur,2394,485,2394,0,2394
30/01/2021,Manipur,2933,539,2933,0,2933
31/01/2021,Manipur,2947,14,2947,0,2947
01/02/2021,Manipur,3321,374,3321,0,3321
02/02/2021,Manipur,3614,293,3614,0,3614
03/02/2021,Manipur,4683,1069,4683,0,4683
04/02/2021,Manipur,4882,199,4882,0,4882
05/02/2021,Manipur,5638,756,5638,0,5638
06/02/2021,Manipur,6981,1343,6981,0,6981
07/02/2021,Manipur,7085,104,7085,0,7085
08/02/2021,Manipur,8785,1700,8785,0,8785
09/02/2021,Manipur,9895,1110,9895,0,9895
10/02/2021,Manipur,12509,2614,12509,0,12509
11/02/2021,Manipur,14562,2053,14562,0,14562
12/02/2021,Manipur,17996,3434,17996,0,17996
13/02/2021,Manipur,20866,2870,20811,55,20811
14/02/2021,Manipur,21453,587,21284,169,21284
15/02/2021,Manipur,24428,2975,24144,284,24144
16/02/2021,Manipur,27506,3078,27091,415,27091
17/02/2021,Manipur,31661,4155,30988,673,30988
18/02/2021,Manipur,34103,2442,33302,801,33302
19/02/2021,Manipur,37210,3107,36102,1108,36102
20/02/2021,Manipur,38877,1667,37523,1354,37523
21/02/2021,Manipur,39179,302,37813,1366,37813
22/02/2021,Manipur,40640,1461,39019,1621,39019
23/02/2021,Manipur,42108,1468,40431,1677,40431
24/02/2021,Manipur,44538,2430,42609,1929,42609
25/02/2021,Manipur,47096,2558,45109,1987,45109
26/02/2021,Manipur,50565,3469,48312,2253,48312
27/02/2021,Manipur,50565,0,48312,2253,48312
28/02/2021,Manipur,50565,0,48312,2253,48312
01/03/2021,Manipur,50565,0,48312,2253,48312
02/03/2021,Manipur,53731,3166,51010,2721,51010
03/03/2021,Manipur,57367,3636,54240,3127,54240
04/03/2021,Manipur,59952,2585,56584,3368,56584
05/03/2021,Manipur,62866,2914,59034,3832,59034
06/03/2021,Manipur,66418,3552,61879,4539,61879
07/03/2021,Manipur,66485,67,61932,4553,61932
08/03/2021,Manipur,69656,3171,63908,5748,63908
09/03/2021,Manipur,66537,-3119,60426,6111,66537
10/03/2021,Manipur,68967,2430,61597,7370,68967
11/03/2021,Manipur,70643,1676,62455,8188,70643
12/03/2021,Manipur,73372,2729,63713,9659,73372
13/03/2021,Manipur,74264,892,64162,10102,74264
14/03/2021,Manipur,74287,23,64185,10102,74287
15/03/2021,Manipur,77264,2977,65326,11938,77264
16/03/2021,Manipur,84604,7340,71446,13158,71446
17/03/2021,Manipur,87642,3038,72675,14967,72675
18/03/2021,Manipur,89359,1717,73312,16047,73312
19/03/2021,Manipur,91987,2628,74154,17833,74154
20/03/2021,Manipur,94867,2880,75140,19727,75140
21/03/2021,Manipur,95182,315,75302,19880,75302
22/03/2021,Manipur,97948,2766,76185,21763,76185
23/03/2021,Manipur,100723,2775,77298,23425,77298
24/03/2021,Manipur,103524,2801,78329,25195,78329
25/03/2021,Manipur,105588,2064,78954,26634,78954
26/03/2021,Manipur,108414,2826,79939,28475,79939
27/03/2021,Manipur,110588,2174,80812,29776,80812
28/03/2021,Manipur,110709,121,80836,29873,80836
29/03/2021,Manipur,110710,1,80834,29876,80834
30/03/2021,Manipur,111499,789,81234,30265,81234
31/03/2021,Manipur,112388,889,81536,30852,81536
01/04/2021,Manipur,113879,1491,82143,31736,82143
02/04/2021,Manipur,114328,449,82302,32026,82302
03/04/2021,Manipur,116963,2635,83195,33768,83195
04/04/2021,Manipur,117983,1020,83536,34447,83536
05/04/2021,Manipur,120166,2183,84193,35973,84193
06/04/2021,Manipur,121511,1345,84616,36895,84616
07/04/2021,Manipur,125009,3498,85872,39137,85872
08/04/2021,Manipur,128096,3087,86907,41189,86907
09/04/2021,Manipur,130943,2847,88290,42653,88290
10/04/2021,Manipur,132200,1257,88814,43386,88814
11/04/2021,Manipur,134396,2196,90439,43957,90439
12/04/2021,Manipur,137680,3284,92519,45161,92519
13/04/2021,Manipur,139965,2285,94163,45802,94163
14/04/2021,Manipur,142872,2907,96373,46499,96373
15/04/2021,Manipur,145449,2577,97755,47694,97755
16/04/2021,Manipur,148586,3137,99881,48705,99881
17/04/2021,Manipur,152126,3540,102116,50010,102116
18/04/2021,Manipur,153104,978,102983,50121,102983
19/04/2021,Manipur,157712,4608,106513,51199,106513
20/04/2021,Manipur,162104,4392,109878,52226,109878
21/04/2021,Manipur,167519,5415,114345,53174,114345
22/04/2021,Manipur,171740,4221,117450,54290,117450
23/04/2021,Manipur,174249,2509,119440,54809,119440
24/04/2021,Manipur,180200,5951,124435,55765,124435
25/04/2021,Manipur,182546,2346,126565,55981,126565
26/04/2021,Manipur,192152,9606,134935,57217,134935
27/04/2021,Manipur,200674,8522,142612,58062,142612
28/04/2021,Manipur,214148,13474,155151,58997,155151
29/04/2021,Manipur,228164,14016,168095,60069,168095
30/04/2021,Manipur,250108,21944,188954,61154,188954
01/05/2021,Manipur,263966,13858,202264,61702,202264
02/05/2021,Manipur,266791,2825,205037,61754,205037
03/05/2021,Manipur,281500,14709,218548,62952,218548
04/05/2021,Manipur,292122,10622,228369,63753,228369
05/05/2021,Manipur,304470,12348,239758,64712,239758
06/05/2021,Manipur,314431,9961,248868,65563,248868
07/05/2021,Manipur,322790,8359,256439,66351,256439
08/05/2021,Manipur,330507,7717,263612,66895,263612
09/05/2021,Manipur,330717,210,263801,66916,263801
10/05/2021,Manipur,341766,11049,273723,68043,273723
11/05/2021,Manipur,350180,8414,281137,69043,281137
12/05/2021,Manipur,358501,8321,289255,69246,289255
13/05/2021,Manipur,364547,6046,295024,69523,295024
14/05/2021,Manipur,370000,5453,300409,69591,300409
15/05/2021,Manipur,376997,6997,307272,69725,307272
16/05/2021,Manipur,377312,315,307585,69727,307585
17/05/2021,Manipur,386041,8729,316243,69798,316243
18/05/2021,Manipur,390976,4935,321100,69876,321100
19/05/2021,Manipur,399475,8499,329532,69943,329532
20/05/2021,Manipur,403292,3817,333308,69984,333308
21/05/2021,Manipur,409970,6678,339942,70028,339942
22/05/2021,Manipur,413778,3808,343712,70066,343712
23/05/2021,Manipur,413789,11,343723,70066,343723
24/05/2021,Manipur,420969,7180,350862,70107,350862
25/05/2021,Manipur,424213,3244,354051,70162,354051
26/05/2021,Manipur,435973,11760,365796,70177,365796
27/05/2021,Manipur,439064,3091,368847,70217,368847
28/05/2021,Manipur,444143,5079,373870,70273,373870
29/05/2021,Manipur,451025,6882,380689,70336,380689
30/05/2021,Manipur,451219,194,380882,70337,380882
31/05/2021,Manipur,457938,6719,387493,70445,387493
01/06/2021,Manipur,462332,4394,391812,70520,391812
02/06/2021,Manipur,469900,7568,399272,70628,399272
03/06/2021,Manipur,472549,2649,401838,70711,401838
04/06/2021,Manipur,483199,10650,412409,70790,412409
05/06/2021,Manipur,492404,9205,421488,70916,421488
06/06/2021,Manipur,492511,107,421595,70916,421595
07/06/2021,Manipur,504594,12083,433599,70995,433599
08/06/2021,Manipur,511639,7045,440535,71104,440535
09/06/2021,Manipur,522579,10940,451370,71209,451370
10/06/2021,Manipur,527496,4917,456202,71294,456202
11/06/2021,Manipur,535179,7683,463768,71411,463768
12/06/2021,Manipur,537537,2358,466105,71432,466105
13/06/2021,Manipur,538075,538,466634,71441,466634
14/06/2021,Manipur,543694,5619,472128,71566,472128
15/06/2021,Manipur,548282,4588,476657,71625,476657
16/06/2021,Manipur,554243,5961,482536,71707,482536
17/06/2021,Manipur,556448,2205,484633,71815,484633
18/06/2021,Manipur,561047,4599,489047,72000,489047
19/06/2021,Manipur,565195,4148,493052,72143,493052
20/06/2021,Manipur,565710,515,493565,72145,493565
21/06/2021,Manipur,572397,6687,500102,72295,500102
22/06/2021,Manipur,576461,4064,504048,72413,504048
23/06/2021,Manipur,582812,6351,510253,72559,510253
24/06/2021,Manipur,588117,5305,515401,72716,515401
25/06/2021,Manipur,596468,8351,523660,72808,
26/06/2021,Manipur,603780,7312,530732,73048,
27/06/2021,Manipur,606673,2893,533606,73067,
28/06/2021,Manipur,621399,14726,548026,73373,
29/06/2021,Manipur,637207,15808,563425,73782,
30/06/2021,Manipur,655247,18040,581109,74138,
01/07/2021,Manipur,672166,16919,597706,74460,
02/07/2021,Manipur,695544,23378,620451,75093,
03/07/2021,Manipur,719567,24023,643877,75690,
04/07/2021,Manipur,729209,9642,653287,75922,
05/07/2021,Manipur,759423,30214,681970,77453,
06/07/2021,Manipur,785691,26268,706878,78813,
07/07/2021,Manipur,816460,30769,735358,81102,
08/07/2021,Manipur,841124,24664,758837,82287,
09/07/2021,Manipur,854304,13180,770529,83775,
10/07/2021,Manipur,861136,6832,776522,84614,
11/07/2021,Manipur,865889,4753,781122,84767,
12/07/2021,Manipur,880377,14488,794059,86318,
13/07/2021,Manipur,911582,31205,821525,90057,
14/07/2021,Manipur,946944,35362,852445,94499,
15/07/2021,Manipur,974479,27535,876836,97643,
16/07/2021,Manipur,1001544,27065,901371,100173,
17/07/2021,Manipur,1027069,25525,923052,104017,
18/07/2021,Manipur,1033928,6859,929481,104447,
19/07/2021,Manipur,1057386,23458,946997,110389,
20/07/2021,Manipur,1082124,24738,965549,116575,
21/07/2021,Manipur,1102219,20095,979839,122380,
22/07/2021,Manipur,1126653,24434,995279,131374,
23/07/2021,Manipur,1155874,29221,1010771,145103,
24/07/2021,Manipur,1186488,30614,1029246,157242,
25/07/2021,Manipur,1197316,10828,1038690,158626,
26/07/2021,Manipur,1225903,28587,1055427,170476,
27/07/2021,Manipur,1244397,18494,1066474,177923,
28/07/2021,Manipur,1267268,22871,1079705,187563,
29/07/2021,Manipur,1282382,15114,1088641,193741,
30/07/2021,Manipur,1298378,15996,1097943,200435,
31/07/2021,Manipur,1313711,15333,1108293,205418,
01/08/2021,Manipur,1320730,7019,1114724,206006,
02/08/2021,Manipur,1334510,13780,1122259,212251,
03/08/2021,Manipur,1345271,10761,1128496,216775,
04/08/2021,Manipur,1358157,12886,1135285,222872,
05/08/2021,Manipur,1366240,8083,1139436,226804,
06/08/2021,Manipur,1379355,13115,1146080,233275,
07/08/2021,Manipur,1389342,9987,1150882,238460,
08/08/2021,Manipur,1392572,3230,1153469,239103,
09/08/2021,Manipur,1406118,13546,1159424,246694,
,,,,,,
,,,,,,
,,,,,,
,,,,,,
,,,,,,
,,,,,,
16/01/2021,Meghalaya,102,102,102,0,102
17/01/2021,Meghalaya,102,0,102,0,102
18/01/2021,Meghalaya,58,-44,58,0,58
19/01/2021,Meghalaya,170,112,170,0,170
20/01/2021,Meghalaya,189,19,189,0,189
21/01/2021,Meghalaya,380,191,380,0,380
22/01/2021,Meghalaya,525,145,525,0,525
23/01/2021,Meghalaya,709,184,709,0,709
24/01/2021,Meghalaya,713,4,713,0,713
25/01/2021,Meghalaya,1249,536,1249,0,1249
26/01/2021,Meghalaya,1256,7,1256,0,1256
27/01/2021,Meghalaya,1964,708,1964,0,1964
28/01/2021,Meghalaya,2609,645,2609,0,2609
29/01/2021,Meghalaya,2925,316,2925,0,2925
30/01/2021,Meghalaya,3070,145,3070,0,3070
31/01/2021,Meghalaya,3076,6,3076,0,3076
01/02/2021,Meghalaya,3317,241,3317,0,3317
02/02/2021,Meghalaya,3451,134,3451,0,3451
03/02/2021,Meghalaya,3565,114,3565,0,3565
04/02/2021,Meghalaya,4216,651,4216,0,4216
05/02/2021,Meghalaya,4933,717,4933,0,4933
06/02/2021,Meghalaya,5585,652,5585,0,5585
07/02/2021,Meghalaya,5585,0,5585,0,5585
08/02/2021,Meghalaya,6394,809,6394,0,6394
09/02/2021,Meghalaya,7806,1412,7806,0,7806
10/02/2021,Meghalaya,8557,751,8557,0,8557
11/02/2021,Meghalaya,10420,1863,10420,0,10420
12/02/2021,Meghalaya,11614,1194,11614,0,11614
13/02/2021,Meghalaya,12996,1382,12905,91,12905
14/02/2021,Meghalaya,12997,1,12906,91,12906
15/02/2021,Meghalaya,15270,2273,15019,251,15019
16/02/2021,Meghalaya,17969,2699,17479,490,17479
17/02/2021,Meghalaya,21964,3995,21153,811,21153
18/02/2021,Meghalaya,25231,3267,23995,1236,23995
19/02/2021,Meghalaya,29028,3797,27429,1599,27429
20/02/2021,Meghalaya,31111,2083,29428,1683,29428
21/02/2021,Meghalaya,31142,31,29459,1683,29459
22/02/2021,Meghalaya,34056,2914,31976,2080,31976
23/02/2021,Meghalaya,37186,3130,34889,2297,34889
24/02/2021,Meghalaya,39128,1942,36656,2472,36656
25/02/2021,Meghalaya,41799,2671,38638,3161,38638
26/02/2021,Meghalaya,43820,2021,40214,3606,40214
27/02/2021,Meghalaya,43820,0,40214,3606,40214
28/02/2021,Meghalaya,43820,0,40214,3606,40214
01/03/2021,Meghalaya,43820,0,40214,3606,40214
02/03/2021,Meghalaya,46335,2515,42313,4022,42313
03/03/2021,Meghalaya,48103,1768,43856,4247,43856
04/03/2021,Meghalaya,49906,1803,45315,4591,45315
05/03/2021,Meghalaya,51694,1788,46494,5200,46494
06/03/2021,Meghalaya,52850,1156,47342,5508,47342
07/03/2021,Meghalaya,52918,68,47343,5575,47343
08/03/2021,Meghalaya,55701,2783,49452,6249,49452
09/03/2021,Meghalaya,52598,-3103,45459,7139,52598
10/03/2021,Meghalaya,55012,2414,47038,7974,55012
11/03/2021,Meghalaya,58246,3234,49110,9136,58246
12/03/2021,Meghalaya,60371,2125,50237,10134,60371
13/03/2021,Meghalaya,61887,1516,50933,10954,61887
14/03/2021,Meghalaya,61893,6,50935,10958,61893
15/03/2021,Meghalaya,64637,2744,52440,12197,64637
16/03/2021,Meghalaya,75591,10954,61441,14150,61441
17/03/2021,Meghalaya,79544,3953,63623,15921,63623
18/03/2021,Meghalaya,83678,4134,65544,18134,65544
19/03/2021,Meghalaya,87664,3986,67370,20294,67370
20/03/2021,Meghalaya,89583,1919,68157,21426,68157
21/03/2021,Meghalaya,89631,48,68189,21442,68189
22/03/2021,Meghalaya,93369,3738,69870,23499,69870
23/03/2021,Meghalaya,97710,4341,71810,25900,71810
24/03/2021,Meghalaya,100271,2561,73095,27176,73095
25/03/2021,Meghalaya,104331,4060,75260,29071,75260
26/03/2021,Meghalaya,106715,2384,76757,29958,76757
27/03/2021,Meghalaya,107235,520,77163,30072,77163
28/03/2021,Meghalaya,107245,10,77173,30072,77173
29/03/2021,Meghalaya,108601,1356,78278,30323,78278
30/03/2021,Meghalaya,110987,2386,79778,31209,79778
31/03/2021,Meghalaya,112575,1588,80790,31785,80790
01/04/2021,Meghalaya,116161,3586,83658,32503,83658
02/04/2021,Meghalaya,116994,833,84328,32666,84328
03/04/2021,Meghalaya,118120,1126,85243,32877,85243
04/04/2021,Meghalaya,118451,331,85528,32923,85528
05/04/2021,Meghalaya,120925,2474,87294,33631,87294
06/04/2021,Meghalaya,122904,1979,88683,34221,88683
07/04/2021,Meghalaya,129112,6208,93455,35657,93455
08/04/2021,Meghalaya,135189,6077,98204,36985,98204
09/04/2021,Meghalaya,139127,3938,101170,37957,101170
10/04/2021,Meghalaya,141326,2199,103084,38242,103084
11/04/2021,Meghalaya,142445,1119,104057,38388,104057
12/04/2021,Meghalaya,146598,4153,107560,39038,107560
13/04/2021,Meghalaya,152825,6227,112619,40206,112619
14/04/2021,Meghalaya,157493,4668,116428,41065,116428
15/04/2021,Meghalaya,163242,5749,120703,42539,120703
16/04/2021,Meghalaya,167533,4291,124078,43455,124078
17/04/2021,Meghalaya,169475,1942,125525,43950,125525
18/04/2021,Meghalaya,169578,103,125611,43967,125611
19/04/2021,Meghalaya,174722,5144,129164,45558,129164
20/04/2021,Meghalaya,180648,5926,133716,46932,133716
21/04/2021,Meghalaya,185229,4581,137342,47887,137342
22/04/2021,Meghalaya,194508,9279,144721,49787,144721
23/04/2021,Meghalaya,203223,8715,151994,51229,151994
24/04/2021,Meghalaya,209522,6299,157665,51857,157665
25/04/2021,Meghalaya,210172,650,158278,51894,158278
26/04/2021,Meghalaya,225338,15166,171659,53679,171659
27/04/2021,Meghalaya,242572,17234,187409,55163,187409
28/04/2021,Meghalaya,258617,16045,201997,56620,201997
29/04/2021,Meghalaya,275009,16392,216622,58387,216622
30/04/2021,Meghalaya,290380,15371,230464,59916,230464
01/05/2021,Meghalaya,298016,7636,237480,60536,237480
02/05/2021,Meghalaya,298411,395,237840,60571,237840
03/05/2021,Meghalaya,307452,9041,245544,61908,245544
04/05/2021,Meghalaya,314897,7445,251797,63100,251797
05/05/2021,Meghalaya,321391,6494,257079,64312,257079
06/05/2021,Meghalaya,330208,8817,264289,65919,264289
07/05/2021,Meghalaya,338720,8512,271522,67198,271522
08/05/2021,Meghalaya,343288,4568,275381,67907,275381
09/05/2021,Meghalaya,343383,95,275458,67925,275458
10/05/2021,Meghalaya,354169,10786,284513,69656,284513
11/05/2021,Meghalaya,366010,11841,294637,71373,294637
12/05/2021,Meghalaya,376361,10351,304094,72267,304094
13/05/2021,Meghalaya,386756,10395,313442,73314,313442
14/05/2021,Meghalaya,395450,8694,321576,73874,321576
15/05/2021,Meghalaya,400823,5373,326762,74061,326762
16/05/2021,Meghalaya,403743,2920,329682,74061,329682
17/05/2021,Meghalaya,410381,6638,336289,74092,336289
18/05/2021,Meghalaya,415533,5152,341428,74105,341428
19/05/2021,Meghalaya,419281,3748,345160,74121,345160
20/05/2021,Meghalaya,424013,4732,349885,74128,349885
21/05/2021,Meghalaya,429752,5739,355602,74150,355602
22/05/2021,Meghalaya,434370,4618,360217,74153,360217
23/05/2021,Meghalaya,435576,1206,361423,74153,361423
24/05/2021,Meghalaya,440675,5099,366496,74179,366496
25/05/2021,Meghalaya,446276,5601,372070,74206,372070
26/05/2021,Meghalaya,449713,3437,375503,74210,375503
27/05/2021,Meghalaya,455066,5353,380830,74236,380830
28/05/2021,Meghalaya,459868,4802,385587,74281,385587
29/05/2021,Meghalaya,463649,3781,389328,74321,389328
30/05/2021,Meghalaya,464224,575,389900,74324,389900
31/05/2021,Meghalaya,465690,1466,391350,74340,391350
01/06/2021,Meghalaya,467917,2227,393547,74370,393547
02/06/2021,Meghalaya,469583,1666,395183,74400,395183
03/06/2021,Meghalaya,471884,2301,397450,74434,397450
04/06/2021,Meghalaya,474607,2723,400152,74455,400152
05/06/2021,Meghalaya,476743,2136,402281,74462,402281
06/06/2021,Meghalaya,476750,7,402288,74462,402288
07/06/2021,Meghalaya,478264,1514,403761,74503,403761
08/06/2021,Meghalaya,479293,1029,404762,74531,404762
09/06/2021,Meghalaya,480229,936,405629,74600,405629
10/06/2021,Meghalaya,482623,2394,407975,74648,407975
11/06/2021,Meghalaya,492296,9673,417634,74662,417634
12/06/2021,Meghalaya,501614,9318,426926,74688,426926
13/06/2021,Meghalaya,503182,1568,428483,74699,428483
14/06/2021,Meghalaya,516828,13646,442099,74729,442099
15/06/2021,Meghalaya,530738,13910,455958,74780,455958
16/06/2021,Meghalaya,544781,14043,469951,74830,469951
17/06/2021,Meghalaya,562928,18147,487996,74932,487996
18/06/2021,Meghalaya,578098,15170,503100,74998,503100
19/06/2021,Meghalaya,589906,11808,514835,75071,514835
20/06/2021,Meghalaya,590972,1066,515897,75075,515897
21/06/2021,Meghalaya,604195,13223,528959,75236,528959
22/06/2021,Meghalaya,617157,12962,541746,75411,541746
23/06/2021,Meghalaya,629639,12482,554067,75572,554067
24/06/2021,Meghalaya,641778,12139,565784,75994,565784
25/06/2021,Meghalaya,655138,13360,578927,76211,
26/06/2021,Meghalaya,663542,8404,587037,76505,
27/06/2021,Meghalaya,664291,749,587769,76522,
28/06/2021,Meghalaya,678691,14400,601229,77462,
29/06/2021,Meghalaya,690638,11947,612010,78628,
30/06/2021,Meghalaya,699213,8575,619732,79481,
01/07/2021,Meghalaya,712223,13010,631279,80944,
02/07/2021,Meghalaya,724020,11797,641366,82654,
03/07/2021,Meghalaya,733404,9384,649906,83498,
04/07/2021,Meghalaya,734356,952,650477,83879,
05/07/2021,Meghalaya,747397,13041,661498,85899,
06/07/2021,Meghalaya,763595,16198,674827,88768,
07/07/2021,Meghalaya,775205,11610,684309,90896,
08/07/2021,Meghalaya,789963,14758,696143,93820,
09/07/2021,Meghalaya,801829,11866,705803,96026,
10/07/2021,Meghalaya,809993,8164,712488,97505,
11/07/2021,Meghalaya,810573,580,712955,97618,
12/07/2021,Meghalaya,824300,13727,723817,100483,
13/07/2021,Meghalaya,839967,15667,736070,103897,
14/07/2021,Meghalaya,853459,13492,746519,106940,
15/07/2021,Meghalaya,870101,16642,758555,111546,
16/07/2021,Meghalaya,886290,16189,769669,116621,
17/07/2021,Meghalaya,897149,10859,777402,119747,
18/07/2021,Meghalaya,897621,472,777736,119885,
19/07/2021,Meghalaya,914978,17357,788233,126745,
20/07/2021,Meghalaya,933601,18623,799336,134265,
21/07/2021,Meghalaya,948045,14444,807162,140883,
22/07/2021,Meghalaya,967622,19577,817913,149709,
23/07/2021,Meghalaya,987072,19450,828240,158832,
24/07/2021,Meghalaya,1000322,13250,836068,164254,
25/07/2021,Meghalaya,1000685,363,836298,164387,
26/07/2021,Meghalaya,1018011,17326,846481,171530,
27/07/2021,Meghalaya,1034494,16483,856343,178151,
28/07/2021,Meghalaya,1047742,13248,864207,183535,
29/07/2021,Meghalaya,1063158,15416,873724,189434,
30/07/2021,Meghalaya,1076028,12870,880967,195061,
31/07/2021,Meghalaya,1086700,10672,888284,198416,
01/08/2021,Meghalaya,1089428,2728,890971,198457,
02/08/2021,Meghalaya,1101175,11747,898411,202764,
03/08/2021,Meghalaya,1113362,12187,906092,207270,
04/08/2021,Meghalaya,1123660,10298,912022,211638,
05/08/2021,Meghalaya,1136576,12916,919824,216752,
06/08/2021,Meghalaya,1149127,12551,927347,221780,
07/08/2021,Meghalaya,1158718,9591,932413,226305,
08/08/2021,Meghalaya,1159425,707,932764,226661,
09/08/2021,Meghalaya,1170554,11129,938572,231982,
,,,,,,
,,,,,,
,,,,,,
,,,,,,
,,,,,,
,,,,,,
16/01/2021,Mizoram,105,105,105,0,105
17/01/2021,Mizoram,105,0,105,0,105
18/01/2021,Mizoram,98,-7,98,0,98
19/01/2021,Mizoram,259,161,259,0,259
20/01/2021,Mizoram,291,32,291,0,291
21/01/2021,Mizoram,632,341,632,0,632
22/01/2021,Mizoram,1494,862,1494,0,1494
23/01/2021,Mizoram,1870,376,1870,0,1870
24/01/2021,Mizoram,1945,75,1945,0,1945
25/01/2021,Mizoram,3087,1142,3087,0,3087
26/01/2021,Mizoram,3115,28,3115,0,3115
27/01/2021,Mizoram,4782,1667,4782,0,4782
28/01/2021,Mizoram,5391,609,5391,0,5391
29/01/2021,Mizoram,7065,1674,7065,0,7065
30/01/2021,Mizoram,7977,912,7977,0,7977
31/01/2021,Mizoram,7977,0,7977,0,7977
01/02/2021,Mizoram,8462,485,8462,0,8462
02/02/2021,Mizoram,8462,0,8462,0,8462
03/02/2021,Mizoram,8525,63,8525,0,8525
04/02/2021,Mizoram,8583,58,8583,0,8583
05/02/2021,Mizoram,9110,527,9110,0,9110
06/02/2021,Mizoram,9470,360,9470,0,9470
07/02/2021,Mizoram,9476,6,9476,0,9476
08/02/2021,Mizoram,9492,16,9492,0,9492
09/02/2021,Mizoram,9603,111,9603,0,9603
10/02/2021,Mizoram,9642,39,9642,0,9642
11/02/2021,Mizoram,9642,0,9642,0,9642
12/02/2021,Mizoram,9941,299,9941,0,9941
13/02/2021,Mizoram,10254,313,10179,75,10179
14/02/2021,Mizoram,10440,186,10365,75,10365
15/02/2021,Mizoram,11394,954,11167,227,11167
16/02/2021,Mizoram,11402,8,11175,227,11175
17/02/2021,Mizoram,12755,1353,12174,581,12174
18/02/2021,Mizoram,14305,1550,12914,1391,12914
19/02/2021,Mizoram,16672,2367,14481,2191,14481
20/02/2021,Mizoram,16918,246,14684,2234,14684
21/02/2021,Mizoram,16918,0,14684,2234,14684
22/02/2021,Mizoram,18808,1890,15775,3033,15775
23/02/2021,Mizoram,20689,1881,17217,3472,17217
24/02/2021,Mizoram,23483,2794,19505,3978,19505
25/02/2021,Mizoram,25618,2135,20768,4850,20768
26/02/2021,Mizoram,27554,1936,21922,5632,21922
27/02/2021,Mizoram,27554,0,21922,5632,21922
28/02/2021,Mizoram,27558,4,21926,5632,21926
01/03/2021,Mizoram,27558,0,21926,5632,21926
02/03/2021,Mizoram,33404,5846,25609,7795,25609
03/03/2021,Mizoram,37776,4372,28887,8889,28887
04/03/2021,Mizoram,40949,3173,31897,9052,31897
05/03/2021,Mizoram,41973,1024,32860,9113,32860
06/03/2021,Mizoram,43202,1229,34027,9175,34027
07/03/2021,Mizoram,43295,93,34115,9180,34115
08/03/2021,Mizoram,44969,1674,35707,9262,35707
09/03/2021,Mizoram,38483,-6486,29116,9367,38483
10/03/2021,Mizoram,42391,3908,32615,9776,42391
11/03/2021,Mizoram,44393,2002,34423,9970,44393
12/03/2021,Mizoram,45638,1245,35607,10031,45638
13/03/2021,Mizoram,46187,549,36085,10102,46187
14/03/2021,Mizoram,46297,110,36127,10170,46297
15/03/2021,Mizoram,48167,1870,37646,10521,48167
16/03/2021,Mizoram,60487,12320,49846,10641,49846
17/03/2021,Mizoram,61546,1059,50734,10812,50734
18/03/2021,Mizoram,62606,1060,51317,11289,51317
19/03/2021,Mizoram,63610,1004,51766,11844,51766
20/03/2021,Mizoram,64315,705,52285,12030,52285
21/03/2021,Mizoram,64323,8,52290,12033,52290
22/03/2021,Mizoram,65068,745,52737,12331,52737
23/03/2021,Mizoram,65994,926,53292,12702,53292
24/03/2021,Mizoram,66383,389,53576,12807,53576
25/03/2021,Mizoram,67197,814,54238,12959,54238
26/03/2021,Mizoram,68394,1197,55046,13348,55046
27/03/2021,Mizoram,68478,84,55117,13361,55117
28/03/2021,Mizoram,68478,0,55117,13361,55117
29/03/2021,Mizoram,68563,85,55127,13436,55127
30/03/2021,Mizoram,69079,516,55372,13707,55372
31/03/2021,Mizoram,69467,388,55525,13942,55525
01/04/2021,Mizoram,70821,1354,56300,14521,56300
02/04/2021,Mizoram,71071,250,56479,14592,56479
03/04/2021,Mizoram,71115,44,56509,14606,56509
04/04/2021,Mizoram,71104,-11,56489,14615,56489
05/04/2021,Mizoram,72921,1817,57385,15536,57385
06/04/2021,Mizoram,74692,1771,58483,16209,58483
07/04/2021,Mizoram,81395,6703,63319,18076,63319
08/04/2021,Mizoram,86987,5592,67481,19506,67481
09/04/2021,Mizoram,92638,5651,71502,21136,71502
10/04/2021,Mizoram,95185,2547,73602,21583,73602
11/04/2021,Mizoram,95806,621,73831,21975,73831
12/04/2021,Mizoram,104685,8879,80821,23864,80821
13/04/2021,Mizoram,112978,8293,87233,25745,87233
14/04/2021,Mizoram,123061,10083,94676,28385,94676
15/04/2021,Mizoram,135355,12294,105054,30301,105054
16/04/2021,Mizoram,148073,12718,117031,31042,117031
17/04/2021,Mizoram,153856,5783,122168,31688,122168
18/04/2021,Mizoram,154183,327,122419,31764,122419
19/04/2021,Mizoram,164801,10618,131756,33045,131756
20/04/2021,Mizoram,174363,9562,139758,34605,139758
21/04/2021,Mizoram,180790,6427,144492,36298,144492
22/04/2021,Mizoram,194062,13272,156035,38027,156035
23/04/2021,Mizoram,206177,12115,166665,39512,166665
24/04/2021,Mizoram,211110,4933,170765,40345,170765
25/04/2021,Mizoram,211220,110,170856,40364,170856
26/04/2021,Mizoram,223397,12177,181115,42282,181115
27/04/2021,Mizoram,235041,11644,191344,43697,191344
28/04/2021,Mizoram,243364,8323,199452,43912,199452
29/04/2021,Mizoram,250446,7082,206116,44330,206116
30/04/2021,Mizoram,256067,5621,211334,44733,211334
01/05/2021,Mizoram,258683,2616,213866,44817,213866
02/05/2021,Mizoram,258830,147,213944,44886,213944
03/05/2021,Mizoram,263667,4837,218549,45118,218549
04/05/2021,Mizoram,267561,3894,221866,45695,221866
05/05/2021,Mizoram,271141,3580,225232,45909,225232
06/05/2021,Mizoram,275391,4250,229045,46346,229045
07/05/2021,Mizoram,277545,2154,230710,46835,230710
08/05/2021,Mizoram,278197,652,231165,47032,231165
09/05/2021,Mizoram,278252,55,231200,47052,231200
10/05/2021,Mizoram,281704,3452,232953,48751,232953
11/05/2021,Mizoram,284591,2887,234267,50324,234267
12/05/2021,Mizoram,286159,1568,235691,50468,235691
13/05/2021,Mizoram,288186,2027,237420,50766,237420
14/05/2021,Mizoram,288999,813,238093,50906,238093
15/05/2021,Mizoram,289770,771,238803,50967,238803
16/05/2021,Mizoram,289783,13,238816,50967,238816
17/05/2021,Mizoram,291676,1893,240707,50969,240707
18/05/2021,Mizoram,294300,2624,243325,50975,243325
19/05/2021,Mizoram,297576,3276,246598,50978,246598
20/05/2021,Mizoram,301229,3653,250250,50979,250250
21/05/2021,Mizoram,303181,1952,252198,50983,252198
22/05/2021,Mizoram,303182,1,252199,50983,252199
23/05/2021,Mizoram,303182,0,252199,50983,252199
24/05/2021,Mizoram,304934,1752,253888,51046,253888
25/05/2021,Mizoram,306513,1579,255454,51059,255454
26/05/2021,Mizoram,307168,655,256107,51061,256107
27/05/2021,Mizoram,308603,1435,257532,51071,257532
28/05/2021,Mizoram,311403,2800,260318,51085,260318
29/05/2021,Mizoram,313383,1980,262296,51087,262296
30/05/2021,Mizoram,313453,70,262366,51087,262366
31/05/2021,Mizoram,315245,1792,264128,51117,264128
01/06/2021,Mizoram,316266,1021,265122,51144,265122
02/06/2021,Mizoram,316742,476,265590,51152,265590
03/06/2021,Mizoram,318199,1457,267028,51171,267028
04/06/2021,Mizoram,322297,4098,271082,51215,271082
05/06/2021,Mizoram,323535,1238,272320,51215,272320
06/06/2021,Mizoram,323536,1,272321,51215,272321
07/06/2021,Mizoram,327729,4193,276319,51410,276319
08/06/2021,Mizoram,331535,3806,279959,51576,279959
09/06/2021,Mizoram,335091,3556,283221,51870,283221
10/06/2021,Mizoram,339631,4540,287744,51887,287744
11/06/2021,Mizoram,342961,3330,290926,52035,290926
12/06/2021,Mizoram,344187,1226,291868,52319,291868
13/06/2021,Mizoram,344187,0,291868,52319,291868
14/06/2021,Mizoram,357314,13127,304964,52350,304964
15/06/2021,Mizoram,373131,15817,320738,52393,320738
16/06/2021,Mizoram,393779,20648,341373,52406,341373
17/06/2021,Mizoram,410513,16734,357878,52635,357878
18/06/2021,Mizoram,421435,10922,368782,52653,368782
19/06/2021,Mizoram,428686,7251,376032,52654,376032
20/06/2021,Mizoram,428686,0,376032,52654,376032
21/06/2021,Mizoram,445820,17134,393007,52813,393007
22/06/2021,Mizoram,473304,27484,420432,52872,420432
23/06/2021,Mizoram,496292,22988,443264,53028,443264
24/06/2021,Mizoram,518600,22308,465500,53100,465500
25/06/2021,Mizoram,540516,21916,487321,53195,
26/06/2021,Mizoram,550381,9865,497141,53240,
27/06/2021,Mizoram,550596,215,497356,53240,
28/06/2021,Mizoram,559934,9338,506474,53460,
29/06/2021,Mizoram,568598,8664,514605,53993,
30/06/2021,Mizoram,573048,4450,518679,54369,
01/07/2021,Mizoram,580553,7505,524954,55599,
02/07/2021,Mizoram,592671,12118,534949,57722,
03/07/2021,Mizoram,600166,7495,540493,59673,
04/07/2021,Mizoram,600379,213,540706,59673,
05/07/2021,Mizoram,611825,11446,548862,62963,
06/07/2021,Mizoram,620536,8711,554889,65647,
07/07/2021,Mizoram,632113,11577,562364,69749,
08/07/2021,Mizoram,649616,17503,572405,77211,
09/07/2021,Mizoram,667224,17608,580502,86722,
10/07/2021,Mizoram,671369,4145,583307,88062,
11/07/2021,Mizoram,671701,332,583639,88062,
12/07/2021,Mizoram,685007,13306,588460,96547,
13/07/2021,Mizoram,695980,10973,592691,103289,
14/07/2021,Mizoram,709269,13289,600309,108960,
15/07/2021,Mizoram,721084,11815,604815,116269,
16/07/2021,Mizoram,733598,12514,608456,125142,
17/07/2021,Mizoram,736794,3196,609286,127508,
18/07/2021,Mizoram,736894,100,609380,127514,
19/07/2021,Mizoram,752265,15371,614347,137918,
20/07/2021,Mizoram,768748,16483,619529,149219,
21/07/2021,Mizoram,773865,5117,621289,152576,
22/07/2021,Mizoram,786131,12266,624169,161962,
23/07/2021,Mizoram,796808,10677,626366,170442,
24/07/2021,Mizoram,798104,1296,626561,171543,
25/07/2021,Mizoram,798300,196,626660,171640,
26/07/2021,Mizoram,803772,5472,628506,175266,
27/07/2021,Mizoram,813058,9286,630725,182333,
28/07/2021,Mizoram,821586,8528,633507,188079,
29/07/2021,Mizoram,827813,6227,636054,191759,
30/07/2021,Mizoram,833577,5764,638077,195500,
31/07/2021,Mizoram,835998,2421,639048,196950,
01/08/2021,Mizoram,840956,4958,643917,197039,
02/08/2021,Mizoram,843115,2159,644954,198161,
03/08/2021,Mizoram,844752,1637,645826,198926,
04/08/2021,Mizoram,847086,2334,647051,200035,
05/08/2021,Mizoram,850582,3496,648848,201734,
06/08/2021,Mizoram,855474,4892,651428,204046,
07/08/2021,Mizoram,858266,2792,653314,204952,
08/08/2021,Mizoram,858368,102,653396,204972,
09/08/2021,Mizoram,861719,3351,654946,206773,
,,,,,,
,,,,,,
,,,,,,
,,,,,,
,,,,,,
,,,,,,
16/01/2021,Nagaland,94,94,94,0,94
17/01/2021,Nagaland,94,0,94,0,94
18/01/2021,Nagaland,315,221,315,0,315
19/01/2021,Nagaland,649,334,649,0,649
20/01/2021,Nagaland,1070,421,1070,0,1070
21/01/2021,Nagaland,1267,197,1267,0,1267
22/01/2021,Nagaland,1563,296,1563,0,1563
23/01/2021,Nagaland,1574,11,1574,0,1574
24/01/2021,Nagaland,1583,9,1583,0,1583
25/01/2021,Nagaland,2447,864,2447,0,2447
26/01/2021,Nagaland,2491,44,2491,0,2491
27/01/2021,Nagaland,3371,880,3371,0,3371
28/01/2021,Nagaland,3485,114,3485,0,3485
29/01/2021,Nagaland,3509,24,3509,0,3509
30/01/2021,Nagaland,3529,20,3529,0,3529
31/01/2021,Nagaland,3530,1,3530,0,3530
01/02/2021,Nagaland,3535,5,3535,0,3535
02/02/2021,Nagaland,3630,95,3630,0,3630
03/02/2021,Nagaland,3781,151,3781,0,3781
04/02/2021,Nagaland,3958,177,3958,0,3958
05/02/2021,Nagaland,4068,110,4068,0,4068
06/02/2021,Nagaland,4092,24,4092,0,4092
07/02/2021,Nagaland,4093,1,4093,0,4093
08/02/2021,Nagaland,4502,409,4502,0,4502
09/02/2021,Nagaland,5380,878,5380,0,5380
10/02/2021,Nagaland,6606,1226,6606,0,6606
11/02/2021,Nagaland,7779,1173,7779,0,7779
12/02/2021,Nagaland,8510,731,8510,0,8510
13/02/2021,Nagaland,9041,531,9041,0,9041
14/02/2021,Nagaland,9298,257,9175,123,9175
15/02/2021,Nagaland,11374,2076,11064,310,11064
16/02/2021,Nagaland,13855,2481,12836,1019,12836
17/02/2021,Nagaland,15897,2042,14478,1419,14478
18/02/2021,Nagaland,18021,2124,15776,2245,15776
19/02/2021,Nagaland,21930,3909,18981,2949,18981
20/02/2021,Nagaland,23239,1309,19801,3438,19801
21/02/2021,Nagaland,23333,94,19895,3438,19895
22/02/2021,Nagaland,25515,2182,21597,3918,21597
23/02/2021,Nagaland,27485,1970,23165,4320,23165
24/02/2021,Nagaland,29733,2248,25078,4655,25078
25/02/2021,Nagaland,31357,1624,26425,4932,26425
26/02/2021,Nagaland,32408,1051,27408,5000,27408
27/02/2021,Nagaland,32408,0,27408,5000,27408
28/02/2021,Nagaland,32408,0,27408,5000,27408
01/03/2021,Nagaland,32408,0,27408,5000,27408
02/03/2021,Nagaland,33666,1258,28489,5177,28489
03/03/2021,Nagaland,35478,1812,30205,5273,30205
04/03/2021,Nagaland,36435,957,31007,5428,31007
05/03/2021,Nagaland,36838,403,31300,5538,31300
06/03/2021,Nagaland,37449,611,31900,5549,31900
07/03/2021,Nagaland,37534,85,31985,5549,31985
08/03/2021,Nagaland,39702,2168,33821,5881,33821
09/03/2021,Nagaland,35039,-4663,28813,6226,35039
10/03/2021,Nagaland,37358,2319,30332,7026,37358
11/03/2021,Nagaland,40079,2721,31853,8226,40079
12/03/2021,Nagaland,40999,920,32272,8727,40999
13/03/2021,Nagaland,41434,435,32391,9043,41434
14/03/2021,Nagaland,41574,140,32404,9170,41574
15/03/2021,Nagaland,44529,2955,33926,10603,44529
16/03/2021,Nagaland,53973,9444,42008,11965,42008
17/03/2021,Nagaland,56257,2284,43476,12781,43476
18/03/2021,Nagaland,58558,2301,44648,13910,44648
19/03/2021,Nagaland,60026,1468,45526,14500,45526
20/03/2021,Nagaland,60616,590,45805,14811,45805
21/03/2021,Nagaland,60847,231,45993,14854,45993
22/03/2021,Nagaland,65231,4384,48252,16979,48252
23/03/2021,Nagaland,68921,3690,50722,18199,50722
24/03/2021,Nagaland,71113,2192,51977,19136,51977
25/03/2021,Nagaland,73282,2169,53328,19954,53328
26/03/2021,Nagaland,73861,579,53766,20095,53766
27/03/2021,Nagaland,74090,229,53903,20187,53903
28/03/2021,Nagaland,74120,30,53931,20189,53931
29/03/2021,Nagaland,74228,108,54037,20191,54037
30/03/2021,Nagaland,77812,3584,56501,21311,56501
31/03/2021,Nagaland,79927,2115,58021,21906,58021
01/04/2021,Nagaland,81935,2008,59588,22347,59588
02/04/2021,Nagaland,82335,400,59916,22419,59916
03/04/2021,Nagaland,82476,141,59973,22503,59973
04/04/2021,Nagaland,82573,97,60027,22546,60027
05/04/2021,Nagaland,85256,2683,61890,23366,61890
06/04/2021,Nagaland,87452,2196,63628,23824,63628
07/04/2021,Nagaland,93357,5905,68608,24749,68608
08/04/2021,Nagaland,97862,4505,72338,25524,72338
09/04/2021,Nagaland,100533,2671,74498,26035,74498
10/04/2021,Nagaland,101480,947,75334,26146,75334
11/04/2021,Nagaland,105837,4357,79469,26368,79469
12/04/2021,Nagaland,113933,8096,86333,27600,86333
13/04/2021,Nagaland,120848,6915,92497,28351,92497
14/04/2021,Nagaland,128130,7282,98957,29173,98957
15/04/2021,Nagaland,133050,4920,102973,30077,102973
16/04/2021,Nagaland,137621,4571,107176,30445,107176
17/04/2021,Nagaland,139052,1431,108525,30527,108525
18/04/2021,Nagaland,140107,1055,109571,30536,109571
19/04/2021,Nagaland,148682,8575,117085,31597,117085
20/04/2021,Nagaland,155195,6513,122616,32579,122616
21/04/2021,Nagaland,162415,7220,128948,33467,128948
22/04/2021,Nagaland,169219,6804,134903,34316,134903
23/04/2021,Nagaland,171602,2383,136694,34908,136694
24/04/2021,Nagaland,172279,677,137232,35047,137232
25/04/2021,Nagaland,172649,370,137582,35067,137582
26/04/2021,Nagaland,178198,5549,141446,36752,141446
27/04/2021,Nagaland,183201,5003,145555,37646,145555
28/04/2021,Nagaland,189590,6389,150753,38837,150753
29/04/2021,Nagaland,195428,5838,155613,39815,155613
30/04/2021,Nagaland,198817,3389,158602,40215,158602
01/05/2021,Nagaland,199845,1028,159555,40290,159555
02/05/2021,Nagaland,200279,434,159934,40345,159934
03/05/2021,Nagaland,205316,5037,163607,41709,163607
04/05/2021,Nagaland,209918,4602,166102,43816,166102
05/05/2021,Nagaland,213511,3593,168825,44686,168825
06/05/2021,Nagaland,216162,2651,170531,45631,170531
07/05/2021,Nagaland,218384,2222,172092,46292,172092
08/05/2021,Nagaland,218617,233,172228,46389,172228
09/05/2021,Nagaland,219061,444,172658,46403,172658
10/05/2021,Nagaland,223069,4008,175150,47919,175150
11/05/2021,Nagaland,226669,3600,177071,49598,177071
12/05/2021,Nagaland,229033,2364,178737,50296,178737
13/05/2021,Nagaland,232245,3212,180874,51371,180874
14/05/2021,Nagaland,233433,1188,181746,51687,181746
15/05/2021,Nagaland,233825,392,182048,51777,182048
16/05/2021,Nagaland,234090,265,182306,51784,182306
17/05/2021,Nagaland,238157,4067,186359,51798,186359
18/05/2021,Nagaland,243561,5404,191742,51819,191742
19/05/2021,Nagaland,245648,2087,193820,51828,193820
20/05/2021,Nagaland,246683,1035,194835,51848,194835
21/05/2021,Nagaland,247243,560,195390,51853,195390
22/05/2021,Nagaland,247345,102,195490,51855,195490
23/05/2021,Nagaland,247513,168,195658,51855,195658
24/05/2021,Nagaland,253384,5871,201525,51859,201525
25/05/2021,Nagaland,259736,6352,207865,51871,207865
26/05/2021,Nagaland,260721,985,208836,51885,208836
27/05/2021,Nagaland,261506,785,209608,51898,209608
28/05/2021,Nagaland,262228,722,210308,51920,210308
29/05/2021,Nagaland,262488,260,210558,51930,210558
30/05/2021,Nagaland,262571,83,210641,51930,210641
31/05/2021,Nagaland,268922,6351,216978,51944,216978
01/06/2021,Nagaland,274959,6037,223006,51953,223006
02/06/2021,Nagaland,277162,2203,225169,51993,225169
03/06/2021,Nagaland,279796,2634,227788,52008,227788
04/06/2021,Nagaland,281682,1886,229634,52048,229634
05/06/2021,Nagaland,281890,208,229841,52049,229841
06/06/2021,Nagaland,282481,591,230426,52055,230426
07/06/2021,Nagaland,291666,9185,239568,52098,239568
08/06/2021,Nagaland,301511,9845,249356,52155,249356
09/06/2021,Nagaland,312189,10678,260001,52188,260001
10/06/2021,Nagaland,320312,8123,268004,52308,268004
11/06/2021,Nagaland,329360,9048,277015,52345,277015
12/06/2021,Nagaland,332870,3510,280522,52348,280522
13/06/2021,Nagaland,336121,3251,283761,52360,283761
14/06/2021,Nagaland,349528,13407,297104,52424,297104
15/06/2021,Nagaland,361734,12206,309229,52505,309229
16/06/2021,Nagaland,373071,11337,320460,52611,320460
17/06/2021,Nagaland,382540,9469,329664,52876,329664
18/06/2021,Nagaland,392226,9686,339208,53018,339208
19/06/2021,Nagaland,395022,2796,341974,53048,341974
20/06/2021,Nagaland,399370,4348,346298,53072,346298
21/06/2021,Nagaland,409572,10202,356362,53210,356362
22/06/2021,Nagaland,419911,10339,366444,53467,366444
23/06/2021,Nagaland,430786,10875,376992,53794,376992
24/06/2021,Nagaland,440810,10024,386200,54610,386200
25/06/2021,Nagaland,452837,12027,398041,54796,
26/06/2021,Nagaland,458432,5595,403587,54845,
27/06/2021,Nagaland,462512,4080,407643,54869,
28/06/2021,Nagaland,475119,12607,419127,55992,
29/06/2021,Nagaland,487762,12643,429862,57900,
30/06/2021,Nagaland,500218,12456,440344,59874,
01/07/2021,Nagaland,509293,9075,447302,61991,
02/07/2021,Nagaland,518347,9054,454265,64082,
03/07/2021,Nagaland,520859,2512,456392,64467,
04/07/2021,Nagaland,526913,6054,461485,65428,
05/07/2021,Nagaland,538942,12029,469971,68971,
06/07/2021,Nagaland,552125,13183,478508,73617,
07/07/2021,Nagaland,564970,12845,486470,78500,
08/07/2021,Nagaland,575372,10402,492720,82652,
09/07/2021,Nagaland,586955,11583,500263,86692,
10/07/2021,Nagaland,589915,2960,502157,87758,
11/07/2021,Nagaland,594317,4402,505475,88842,
12/07/2021,Nagaland,606945,12628,512320,94625,
13/07/2021,Nagaland,618772,11827,519353,99419,
14/07/2021,Nagaland,633282,14510,528576,104706,
15/07/2021,Nagaland,643785,10503,534668,109117,
16/07/2021,Nagaland,653588,9803,541764,111824,
17/07/2021,Nagaland,657850,4262,545012,112838,
18/07/2021,Nagaland,665218,7368,550447,114771,
19/07/2021,Nagaland,679321,14103,560636,118685,
20/07/2021,Nagaland,692524,13203,569978,122546,
21/07/2021,Nagaland,704472,11948,577392,127080,
22/07/2021,Nagaland,714870,10398,583739,131131,
23/07/2021,Nagaland,724280,9410,589807,134473,
24/07/2021,Nagaland,727512,3232,592238,135274,
25/07/2021,Nagaland,730846,3334,594445,136401,
26/07/2021,Nagaland,739944,9098,599958,139986,
27/07/2021,Nagaland,747478,7534,604714,142764,
28/07/2021,Nagaland,753720,6242,608661,145059,
29/07/2021,Nagaland,758573,4853,611482,147091,
30/07/2021,Nagaland,763174,4601,614449,148725,
31/07/2021,Nagaland,765106,1932,615940,149166,
01/08/2021,Nagaland,767610,2504,617873,149737,
02/08/2021,Nagaland,772311,4701,620923,151388,
03/08/2021,Nagaland,776067,3756,623306,152761,
04/08/2021,Nagaland,779573,3506,625565,154008,
05/08/2021,Nagaland,782451,2878,627146,155305,
06/08/2021,Nagaland,785511,3060,629122,156389,
07/08/2021,Nagaland,786795,1284,629818,156977,
08/08/2021,Nagaland,787394,599,630228,157166,
09/08/2021,Nagaland,791508,4114,632120,159388,
,,,,,,
,,,,,,
,,,,,,
,,,,,,
,,,,,,
,,,,,,
16/01/2021,Odisha,3420,3420,3420,0,3420
17/01/2021,Odisha,3536,116,3536,0,3536
18/01/2021,Odisha,7591,4055,7591,0,7591
19/01/2021,Odisha,14807,7216,14807,0,14807
20/01/2021,Odisha,18568,3761,18568,0,18568
21/01/2021,Odisha,45331,26763,45331,0,45331
22/01/2021,Odisha,59241,13910,59241,0,59241
23/01/2021,Odisha,89092,29851,89092,0,89092
24/01/2021,Odisha,93846,4754,93846,0,93846
25/01/2021,Odisha,120698,26852,120698,0,120698
26/01/2021,Odisha,122870,2172,122870,0,122870
27/01/2021,Odisha,130317,7447,130317,0,130317
28/01/2021,Odisha,145998,15681,145998,0,145998
29/01/2021,Odisha,156711,10713,156711,0,156711
30/01/2021,Odisha,158329,1618,158329,0,158329
31/01/2021,Odisha,158567,238,158567,0,158567
01/02/2021,Odisha,159914,1347,159914,0,159914
02/02/2021,Odisha,161078,1164,161078,0,161078
03/02/2021,Odisha,165753,4675,165753,0,165753
04/02/2021,Odisha,186187,20434,186187,0,186187
05/02/2021,Odisha,190943,4756,190943,0,190943
06/02/2021,Odisha,220401,29458,220401,0,220401
07/02/2021,Odisha,223714,3313,223714,0,223714
08/02/2021,Odisha,255650,31936,255650,0,255650
09/02/2021,Odisha,282491,26841,282491,0,282491
10/02/2021,Odisha,316166,33675,316166,0,316166
11/02/2021,Odisha,334559,18393,334559,0,334559
12/02/2021,Odisha,350417,15858,350417,0,350417
13/02/2021,Odisha,360206,9789,360203,3,360203
14/02/2021,Odisha,360679,473,360676,3,360676
15/02/2021,Odisha,377078,16399,370662,6416,370662
16/02/2021,Odisha,380202,3124,373167,7035,373167
17/02/2021,Odisha,392505,12303,380869,11636,380869
18/02/2021,Odisha,407988,15483,373908,34080,373908
19/02/2021,Odisha,462576,54588,414702,47874,414702
20/02/2021,Odisha,489793,27217,419252,70541,419252
21/02/2021,Odisha,491506,1713,419492,72014,419492
22/02/2021,Odisha,519365,27859,423769,95596,423769
23/02/2021,Odisha,531427,12062,427468,103959,427468
24/02/2021,Odisha,539997,8570,430731,109266,430731
25/02/2021,Odisha,564070,24073,437478,126592,437478
26/02/2021,Odisha,573790,9720,440499,133291,440499
27/02/2021,Odisha,573826,36,440535,133291,440535
28/02/2021,Odisha,573828,2,440537,133291,440537
01/03/2021,Odisha,573828,0,440537,133291,440537
02/03/2021,Odisha,608953,35125,469228,139725,469228
03/03/2021,Odisha,636348,27395,493470,142878,493470
04/03/2021,Odisha,678170,41822,525756,152414,525756
05/03/2021,Odisha,705107,26937,548018,157089,548018
06/03/2021,Odisha,744565,39458,579310,165255,579310
07/03/2021,Odisha,749077,4512,582986,166091,582986
08/03/2021,Odisha,820328,71251,628602,191726,628602
09/03/2021,Odisha,707189,-113139,494050,213139,707189
10/03/2021,Odisha,750951,43762,522145,228806,750951
11/03/2021,Odisha,758859,7908,527341,231518,758859
12/03/2021,Odisha,825025,66166,570575,254450,825025
13/03/2021,Odisha,883368,58343,614739,268629,883368
14/03/2021,Odisha,890304,6936,620914,269390,890304
15/03/2021,Odisha,980682,90378,693949,286733,980682
16/03/2021,Odisha,1270396,289714,972659,297737,972659
17/03/2021,Odisha,1380895,110499,1076777,304118,1076777
18/03/2021,Odisha,1471638,90743,1161063,310575,1161063
19/03/2021,Odisha,1565021,93383,1247971,317050,1247971
20/03/2021,Odisha,1661845,96824,1339420,322425,1339420
21/03/2021,Odisha,1691518,29673,1367960,323558,1367960
22/03/2021,Odisha,1750576,59058,1423067,327509,1423067
23/03/2021,Odisha,1855753,105177,1521647,334106,1521647
24/03/2021,Odisha,1916772,61019,1579476,337296,1579476
25/03/2021,Odisha,1988898,72126,1646834,342064,1646834
26/03/2021,Odisha,2054400,65502,1708797,345603,1708797
27/03/2021,Odisha,2125480,71080,1777232,348248,1777232
28/03/2021,Odisha,2136507,11027,1788115,348392,1788115
29/03/2021,Odisha,2137175,668,1788762,348413,1788762
30/03/2021,Odisha,2216101,78926,1859488,356613,1859488
31/03/2021,Odisha,2297640,81539,1931226,366414,1931226
01/04/2021,Odisha,2383139,85499,2010503,372636,2010503
02/04/2021,Odisha,2600813,217674,2216025,384788,2216025
03/04/2021,Odisha,2788139,187326,2393427,394712,2393427
04/04/2021,Odisha,3069354,281215,2663583,405771,2663583
05/04/2021,Odisha,3208252,138898,2793731,414521,2793731
06/04/2021,Odisha,3375907,167655,2952028,423879,2952028
07/04/2021,Odisha,3565852,189945,3129687,436165,3129687
08/04/2021,Odisha,3763100,197248,3311254,451846,3311254
09/04/2021,Odisha,3950514,187414,3480440,470074,3480440
10/04/2021,Odisha,4087959,137445,3604413,483546,3604413
11/04/2021,Odisha,4210619,122660,3715949,494670,3715949
12/04/2021,Odisha,4351791,141172,3839733,512058,3839733
13/04/2021,Odisha,4441397,89606,3919536,521861,3919536
14/04/2021,Odisha,4526576,85179,3991742,534834,3991742
15/04/2021,Odisha,4675143,148567,4111307,563836,4111307
16/04/2021,Odisha,4791946,116803,4205256,586690,4205256
17/04/2021,Odisha,4863969,72023,4260933,603036,4260933
18/04/2021,Odisha,4928619,64650,4310037,618582,4310037
19/04/2021,Odisha,5068071,139452,4409637,658434,4409637
20/04/2021,Odisha,5190262,122191,4495861,694401,4495861
21/04/2021,Odisha,5303528,113266,4577788,725740,4577788
22/04/2021,Odisha,5394733,91205,4642130,752603,4642130
23/04/2021,Odisha,5508466,113733,4720273,788193,4720273
24/04/2021,Odisha,5526978,18512,4733651,793327,4733651
25/04/2021,Odisha,5530079,3101,4735952,794127,4735952
26/04/2021,Odisha,5615286,85207,4789048,826238,4789048
27/04/2021,Odisha,5691740,76454,4837588,854152,4837588
28/04/2021,Odisha,5741648,49908,4867136,874512,4867136
29/04/2021,Odisha,5778140,36492,4889024,889116,4889024
30/04/2021,Odisha,5856695,78555,4928197,928498,4928197
01/05/2021,Odisha,5871726,15031,4938147,933579,4938147
02/05/2021,Odisha,5874337,2611,4939787,934550,4939787
03/05/2021,Odisha,5920244,45907,4958904,961340,4958904
04/05/2021,Odisha,5951030,30786,4974065,976965,4974065
05/05/2021,Odisha,5975193,24163,4987030,988163,4987030
06/05/2021,Odisha,6028359,53166,5006410,1021949,5006410
07/05/2021,Odisha,6115427,87068,5032726,1082701,5032726
08/05/2021,Odisha,6190506,75079,5056397,1134109,5056397
09/05/2021,Odisha,6199403,8897,5060884,1138519,5060884
10/05/2021,Odisha,6344014,144611,5094833,1249181,5094833
11/05/2021,Odisha,6457266,113252,5135650,1321616,5135650
12/05/2021,Odisha,6522664,65398,5170331,1352333,5170331
13/05/2021,Odisha,6575980,53316,5202998,1372982,5202998
14/05/2021,Odisha,6625243,49263,5229023,1396220,5229023
15/05/2021,Odisha,6661562,36319,5256185,1405377,5256185
16/05/2021,Odisha,6662987,1425,5257596,1405391,5257596
17/05/2021,Odisha,6723547,60560,5310623,1412924,5310623
18/05/2021,Odisha,6830272,106725,5410278,1419994,5410278
19/05/2021,Odisha,6905443,75171,5478370,1427073,5478370
20/05/2021,Odisha,6965104,59661,5532870,1432234,5532870
21/05/2021,Odisha,7015983,50879,5579295,1436688,5579295
22/05/2021,Odisha,7101273,85290,5660022,1441251,5660022
23/05/2021,Odisha,7116916,15643,5675506,1441410,5675506
24/05/2021,Odisha,7229111,112195,5783311,1445800,5783311
25/05/2021,Odisha,7326673,97562,5877636,1449037,5877636
26/05/2021,Odisha,7376765,50092,5927514,1449251,5927514
27/05/2021,Odisha,7479227,102462,6025025,1454202,6025025
28/05/2021,Odisha,7603639,124412,6139613,1464026,6139613
29/05/2021,Odisha,7708912,105273,6238288,1470624,6238288
30/05/2021,Odisha,7727970,19058,6257322,1470648,6257322
31/05/2021,Odisha,7857798,129828,6380707,1477091,6380707
01/06/2021,Odisha,7962783,104985,6479679,1483104,6479679
02/06/2021,Odisha,8035993,73210,6549112,1486881,6549112
03/06/2021,Odisha,8110698,74705,6619136,1491562,6619136
04/06/2021,Odisha,8201860,91162,6703769,1498091,6703769
05/06/2021,Odisha,8283001,81141,6778101,1504900,6778101
06/06/2021,Odisha,8296256,13255,6791199,1505057,6791199
07/06/2021,Odisha,8462518,166262,6938186,1524332,6938186
08/06/2021,Odisha,8613888,151370,7068512,1545376,7068512
09/06/2021,Odisha,8749836,135948,7183142,1566694,7183142
10/06/2021,Odisha,8806405,56569,7225627,1580778,7225627
11/06/2021,Odisha,8905797,99392,7298756,1607041,7298756
12/06/2021,Odisha,8977717,71920,7347971,1629746,7347971
13/06/2021,Odisha,8987379,9662,7356287,1631092,7356287
14/06/2021,Odisha,9061121,73742,7407091,1654030,7407091
15/06/2021,Odisha,9186151,125030,7503538,1682613,7503538
16/06/2021,Odisha,9350452,164301,7631412,1719040,7631412
17/06/2021,Odisha,9506300,155848,7756546,1749754,7756546
18/06/2021,Odisha,9656101,149801,7882328,1773773,7882328
19/06/2021,Odisha,9825907,169806,8019234,1806673,8019234
20/06/2021,Odisha,9846132,20225,8037617,1808515,8037617
21/06/2021,Odisha,10149548,303416,8309521,1840027,8309521
22/06/2021,Odisha,10441470,291922,8574489,1866981,8574489
23/06/2021,Odisha,10765825,324355,8874332,1891493,8874332
24/06/2021,Odisha,11052797,286972,9126091,1926706,9126091
25/06/2021,Odisha,11295459,242662,9327880,1967579,
26/06/2021,Odisha,11539203,243744,9516596,2022607,
27/06/2021,Odisha,11571633,32430,9541199,2030434,
28/06/2021,Odisha,11832106,260473,9732379,2099727,
29/06/2021,Odisha,11960777,128671,9824050,2136727,
30/06/2021,Odisha,12016338,55561,9868098,2148240,
01/07/2021,Odisha,12055072,38734,9899612,2155460,
02/07/2021,Odisha,12089892,34820,9927123,2162769,
03/07/2021,Odisha,12202018,112126,9995817,2206201,
04/07/2021,Odisha,12237284,35266,10017218,2220066,
05/07/2021,Odisha,12586866,349582,10217642,2369224,
06/07/2021,Odisha,12923503,336637,10418842,2504661,
07/07/2021,Odisha,13129991,206488,10541012,2588979,
08/07/2021,Odisha,13275073,145082,10623119,2651954,
09/07/2021,Odisha,13376305,101232,10682934,2693371,
10/07/2021,Odisha,13443455,67150,10726646,2716809,
11/07/2021,Odisha,13451477,8022,10732651,2718826,
12/07/2021,Odisha,13502341,50864,10773343,2728998,
13/07/2021,Odisha,13577304,74963,10830287,2747017,
14/07/2021,Odisha,13815672,238368,10994545,2821127,
15/07/2021,Odisha,14014960,199288,11090865,2924095,
16/07/2021,Odisha,14143588,128628,11146869,2996719,
17/07/2021,Odisha,14261550,117962,11189648,3071902,
18/07/2021,Odisha,14275865,14315,11197418,3078447,
19/07/2021,Odisha,14571472,295607,11329406,3242066,
20/07/2021,Odisha,14789563,218091,11441234,3348329,
21/07/2021,Odisha,14920471,130908,11512354,3408117,
22/07/2021,Odisha,15102699,182228,11611338,3491361,
23/07/2021,Odisha,15244333,141634,11694484,3549849,
24/07/2021,Odisha,15394878,150545,11786884,3607994,
25/07/2021,Odisha,15417257,22379,11803367,3613890,
26/07/2021,Odisha,15617944,200687,11939137,3678807,
27/07/2021,Odisha,15811574,193630,12064903,3746671,
28/07/2021,Odisha,16002897,191323,12206638,3796259,
29/07/2021,Odisha,16162194,159297,12330934,3831260,
30/07/2021,Odisha,16344336,182142,12469151,3875185,
31/07/2021,Odisha,16499079,154743,12583606,3915473,
01/08/2021,Odisha,16636971,137892,12717390,3919581,
02/08/2021,Odisha,16828261,191290,12868643,3959618,
03/08/2021,Odisha,17054001,225740,13052061,4001940,
04/08/2021,Odisha,17249912,195911,13208415,4041497,
05/08/2021,Odisha,17483880,233968,13404289,4079591,
06/08/2021,Odisha,17713585,229705,13595005,4118580,
07/08/2021,Odisha,17877357,163772,13727085,4150272,
08/08/2021,Odisha,17903256,25899,13749311,4153945,
09/08/2021,Odisha,18154686,251430,13954592,4200094,
,,,,,,
,,,,,,
,,,,,,
,,,,,,
,,,,,,
,,,,,,
16/01/2021,Puducherry,92,92,92,0,92
17/01/2021,Puducherry,92,0,92,0,92
18/01/2021,Puducherry,128,36,128,0,128
19/01/2021,Puducherry,249,121,249,0,249
20/01/2021,Puducherry,249,0,249,0,249
21/01/2021,Puducherry,249,0,249,0,249
22/01/2021,Puducherry,440,191,440,0,440
23/01/2021,Puducherry,813,373,813,0,813
24/01/2021,Puducherry,870,57,870,0,870
25/01/2021,Puducherry,1200,330,1200,0,1200
26/01/2021,Puducherry,1205,5,1205,0,1205
27/01/2021,Puducherry,1274,69,1274,0,1274
28/01/2021,Puducherry,1302,28,1302,0,1302
29/01/2021,Puducherry,1684,382,1684,0,1684
30/01/2021,Puducherry,2069,385,2069,0,2069
31/01/2021,Puducherry,2077,8,2077,0,2077
01/02/2021,Puducherry,2316,239,2316,0,2316
02/02/2021,Puducherry,2472,156,2472,0,2472
03/02/2021,Puducherry,2640,168,2640,0,2640
04/02/2021,Puducherry,2640,0,2640,0,2640
05/02/2021,Puducherry,2984,344,2984,0,2984
06/02/2021,Puducherry,2984,0,2984,0,2984
07/02/2021,Puducherry,2984,0,2984,0,2984
08/02/2021,Puducherry,3326,342,3326,0,3326
09/02/2021,Puducherry,3728,402,3728,0,3728
10/02/2021,Puducherry,4135,407,4135,0,4135
11/02/2021,Puducherry,4144,9,4144,0,4144
12/02/2021,Puducherry,4740,596,4740,0,4740
13/02/2021,Puducherry,5311,571,5243,68,5243
14/02/2021,Puducherry,5311,0,5243,68,5243
15/02/2021,Puducherry,5974,663,5784,190,5784
16/02/2021,Puducherry,6502,528,6197,305,6197
17/02/2021,Puducherry,7072,570,6715,357,6715
18/02/2021,Puducherry,7433,361,7023,410,7023
19/02/2021,Puducherry,8863,1430,8264,599,8264
20/02/2021,Puducherry,9790,927,8983,807,8983
21/02/2021,Puducherry,9790,0,8983,807,8983
22/02/2021,Puducherry,10023,233,9092,931,9092
23/02/2021,Puducherry,10132,109,9167,965,9167
24/02/2021,Puducherry,10288,156,9295,993,9295
25/02/2021,Puducherry,10599,311,9583,1016,9583
26/02/2021,Puducherry,11254,655,10049,1205,10049
27/02/2021,Puducherry,11254,0,10049,1205,10049
28/02/2021,Puducherry,11254,0,10049,1205,10049
01/03/2021,Puducherry,11254,0,10049,1205,10049
02/03/2021,Puducherry,11912,658,10508,1404,10508
03/03/2021,Puducherry,13087,1175,11468,1619,11468
04/03/2021,Puducherry,14349,1262,12632,1717,12632
05/03/2021,Puducherry,15833,1484,13862,1971,13862
06/03/2021,Puducherry,17181,1348,14965,2216,14965
07/03/2021,Puducherry,17186,5,14969,2217,14969
08/03/2021,Puducherry,18840,1654,16432,2408,16432
09/03/2021,Puducherry,17940,-900,15179,2761,17940
10/03/2021,Puducherry,19610,1670,16605,3005,19610
11/03/2021,Puducherry,21232,1622,18039,3193,21232
12/03/2021,Puducherry,22707,1475,19243,3464,22707
13/03/2021,Puducherry,24491,1784,20730,3761,24491
14/03/2021,Puducherry,24531,40,20768,3763,24531
15/03/2021,Puducherry,26694,2163,22703,3991,26694
16/03/2021,Puducherry,32136,5442,27876,4260,27876
17/03/2021,Puducherry,36669,4533,32194,4475,32194
18/03/2021,Puducherry,39618,2949,34800,4818,34800
19/03/2021,Puducherry,42192,2574,36968,5224,36968
20/03/2021,Puducherry,45828,3636,40127,5701,40127
21/03/2021,Puducherry,45978,150,40268,5710,40268
22/03/2021,Puducherry,48951,2973,43031,5920,43031
23/03/2021,Puducherry,52280,3329,46116,6164,46116
24/03/2021,Puducherry,56958,4678,50684,6274,50684
25/03/2021,Puducherry,59759,2801,53365,6394,53365
26/03/2021,Puducherry,62652,2893,56090,6562,56090
27/03/2021,Puducherry,64971,2319,58304,6667,58304
28/03/2021,Puducherry,65161,190,58488,6673,58488
29/03/2021,Puducherry,67152,1991,60388,6764,60388
30/03/2021,Puducherry,71126,3974,64226,6900,64226
31/03/2021,Puducherry,74753,3627,67621,7132,67621
01/04/2021,Puducherry,77091,2338,69782,7309,69782
02/04/2021,Puducherry,78346,1255,70861,7485,70861
03/04/2021,Puducherry,81940,3594,74261,7679,74261
04/04/2021,Puducherry,83745,1805,75948,7797,75948
05/04/2021,Puducherry,85304,1559,77297,8007,77297
06/04/2021,Puducherry,85827,523,77736,8091,77736
07/04/2021,Puducherry,87366,1539,79066,8300,79066
08/04/2021,Puducherry,90173,2807,81449,8724,81449
09/04/2021,Puducherry,93170,2997,83995,9175,83995
10/04/2021,Puducherry,96811,3641,87196,9615,87196
11/04/2021,Puducherry,103620,6809,93853,9767,93853
12/04/2021,Puducherry,114625,11005,104283,10342,104283
13/04/2021,Puducherry,129315,14690,118447,10868,118447
14/04/2021,Puducherry,138227,8912,127116,11111,127116
15/04/2021,Puducherry,148463,10236,136506,11957,136506
16/04/2021,Puducherry,157568,9105,144696,12872,144696
17/04/2021,Puducherry,163838,6270,150119,13719,150119
18/04/2021,Puducherry,165720,1882,151720,14000,151720
19/04/2021,Puducherry,168746,3026,153689,15057,153689
20/04/2021,Puducherry,170884,2138,155023,15861,155023
21/04/2021,Puducherry,173842,2958,157027,16815,157027
22/04/2021,Puducherry,176632,2790,158784,17848,158784
23/04/2021,Puducherry,179593,2961,160575,19018,160575
24/04/2021,Puducherry,181793,2200,161889,19904,161889
25/04/2021,Puducherry,182376,583,162241,20135,162241
26/04/2021,Puducherry,185241,2865,163596,21645,163596
27/04/2021,Puducherry,187897,2656,164814,23083,164814
28/04/2021,Puducherry,190808,2911,166115,24693,166115
29/04/2021,Puducherry,193958,3150,167707,26251,167707
30/04/2021,Puducherry,197864,3906,169488,28376,169488
01/05/2021,Puducherry,199568,1704,170421,29147,170421
02/05/2021,Puducherry,200100,532,170746,29354,170746
03/05/2021,Puducherry,202793,2693,171878,30915,171878
04/05/2021,Puducherry,204860,2067,172686,32174,172686
05/05/2021,Puducherry,207774,2914,173767,34007,173767
06/05/2021,Puducherry,210910,3136,174826,36084,174826
07/05/2021,Puducherry,214047,3137,175852,38195,175852
08/05/2021,Puducherry,216758,2711,176721,40037,176721
09/05/2021,Puducherry,217269,511,176917,40352,176917
10/05/2021,Puducherry,220887,3618,178079,42808,178079
11/05/2021,Puducherry,223390,2503,178838,44552,178838
12/05/2021,Puducherry,225487,2097,179489,45998,179489
13/05/2021,Puducherry,228252,2765,180489,47763,180489
14/05/2021,Puducherry,230849,2597,181667,49182,181667
15/05/2021,Puducherry,233493,2644,183038,50455,183038
16/05/2021,Puducherry,234107,614,183604,50503,183604
17/05/2021,Puducherry,235311,1204,184667,50644,184667
18/05/2021,Puducherry,236280,969,185565,50715,185565
19/05/2021,Puducherry,237296,1016,186539,50757,186539
20/05/2021,Puducherry,239946,2650,189131,50815,189131
21/05/2021,Puducherry,242269,2323,191439,50830,191439
22/05/2021,Puducherry,244618,2349,193758,50860,193758
23/05/2021,Puducherry,246119,1501,195225,50894,195225
24/05/2021,Puducherry,248922,2803,197993,50929,197993
25/05/2021,Puducherry,251483,2561,200518,50965,200518
26/05/2021,Puducherry,254227,2744,203231,50996,203231
27/05/2021,Puducherry,257055,2828,206019,51036,206019
28/05/2021,Puducherry,260310,3255,209222,51088,209222
29/05/2021,Puducherry,263594,3284,212447,51147,212447
30/05/2021,Puducherry,265768,2174,214593,51175,214593
31/05/2021,Puducherry,269328,3560,218077,51251,218077
01/06/2021,Puducherry,272660,3332,221333,51327,221333
02/06/2021,Puducherry,276052,3392,224650,51402,224650
03/06/2021,Puducherry,279327,3275,227847,51480,227847
04/06/2021,Puducherry,282192,2865,230627,51565,230627
05/06/2021,Puducherry,286551,4359,234886,51665,234886
06/06/2021,Puducherry,289091,2540,237400,51691,237400
07/06/2021,Puducherry,294440,5349,242580,51860,242580
08/06/2021,Puducherry,300252,5812,248250,52002,248250
09/06/2021,Puducherry,305651,5399,253425,52226,253425
10/06/2021,Puducherry,311816,6165,259372,52444,259372
11/06/2021,Puducherry,317562,5746,264921,52641,264921
12/06/2021,Puducherry,324744,7182,271888,52856,271888
13/06/2021,Puducherry,327232,2488,274317,52915,274317
14/06/2021,Puducherry,334027,6795,280850,53177,280850
15/06/2021,Puducherry,339695,5668,286199,53496,286199
16/06/2021,Puducherry,353121,13426,299122,53999,299122
17/06/2021,Puducherry,368948,15827,314298,54650,314298
18/06/2021,Puducherry,385272,16324,330113,55159,330113
19/06/2021,Puducherry,410129,24857,354186,55943,354186
20/06/2021,Puducherry,418672,8543,362503,56169,362503
21/06/2021,Puducherry,436571,17899,379550,57021,379550
22/06/2021,Puducherry,445363,8792,387363,58000,387363
23/06/2021,Puducherry,454182,8819,394822,59360,394822
24/06/2021,Puducherry,462497,8315,401988,60509,401988
25/06/2021,Puducherry,469829,7332,408440,61389,
26/06/2021,Puducherry,479491,9662,416622,62869,
27/06/2021,Puducherry,481902,2411,418640,63262,
28/06/2021,Puducherry,492598,10696,427897,64701,
29/06/2021,Puducherry,499979,7381,434377,65602,
30/06/2021,Puducherry,507468,7489,440363,67105,
01/07/2021,Puducherry,513535,6067,445152,68383,
02/07/2021,Puducherry,518831,5296,448960,69871,
03/07/2021,Puducherry,526345,7514,454281,72064,
04/07/2021,Puducherry,529509,3164,455749,73760,
05/07/2021,Puducherry,539096,9587,460594,78502,
06/07/2021,Puducherry,548593,9497,463933,84660,
07/07/2021,Puducherry,558068,9475,467894,90174,
08/07/2021,Puducherry,566525,8457,470882,95643,
09/07/2021,Puducherry,574935,8410,473954,100981,
10/07/2021,Puducherry,586989,12054,479916,107073,
11/07/2021,Puducherry,594602,7613,484522,110080,
12/07/2021,Puducherry,610205,15603,493582,116623,
13/07/2021,Puducherry,615861,5656,496806,119055,
14/07/2021,Puducherry,628690,12829,506999,121691,
15/07/2021,Puducherry,633987,5297,510271,123716,
16/07/2021,Puducherry,639723,5736,513820,125903,
17/07/2021,Puducherry,645742,6019,517902,127840,
18/07/2021,Puducherry,647196,1454,519005,128191,
19/07/2021,Puducherry,654259,7063,523930,130329,
20/07/2021,Puducherry,660092,5833,528009,132083,
21/07/2021,Puducherry,662515,2423,529753,132762,
22/07/2021,Puducherry,667591,5076,533073,134518,
23/07/2021,Puducherry,674602,7011,538189,136413,
24/07/2021,Puducherry,684227,9625,545647,138580,
25/07/2021,Puducherry,685245,1018,546427,138818,
26/07/2021,Puducherry,690732,5487,550512,140220,
27/07/2021,Puducherry,694875,4143,553579,141296,
28/07/2021,Puducherry,698810,3935,556500,142310,
29/07/2021,Puducherry,704580,5770,561167,143413,
30/07/2021,Puducherry,710066,5486,565700,144366,
31/07/2021,Puducherry,717225,7159,571733,145492,
01/08/2021,Puducherry,720359,3134,574646,145713,
02/08/2021,Puducherry,724468,4109,577955,146513,
03/08/2021,Puducherry,728541,4073,581231,147310,
04/08/2021,Puducherry,733207,4666,585148,148059,
05/08/2021,Puducherry,737452,4245,588671,148781,
06/08/2021,Puducherry,741807,4355,592246,149561,
07/08/2021,Puducherry,746814,5007,596334,150480,
08/08/2021,Puducherry,748322,1508,597542,150780,
09/08/2021,Puducherry,753362,5040,601591,151771,
,,,,,,
,,,,,,
,,,,,,
,,,,,,
,,,,,,
,,,,,,
16/01/2021,Punjab,336,336,336,0,336
17/01/2021,Punjab,338,2,338,0,338
18/01/2021,Punjab,678,340,678,0,678
19/01/2021,Punjab,1529,851,1529,0,1529
20/01/2021,Punjab,2432,903,2432,0,2432
21/01/2021,Punjab,4780,2348,4780,0,4780
22/01/2021,Punjab,9676,4896,9676,0,9676
23/01/2021,Punjab,16519,6843,16519,0,16519
24/01/2021,Punjab,17712,1193,17712,0,17712
25/01/2021,Punjab,26017,8305,26017,0,26017
26/01/2021,Punjab,26213,196,26213,0,26213
27/01/2021,Punjab,33121,6908,33121,0,33121
28/01/2021,Punjab,39511,6390,39511,0,39511
29/01/2021,Punjab,42210,2699,42210,0,42210
30/01/2021,Punjab,45648,3438,45648,0,45648
31/01/2021,Punjab,45738,90,45738,0,45738
01/02/2021,Punjab,47903,2165,47903,0,47903
02/02/2021,Punjab,49663,1760,49663,0,49663
03/02/2021,Punjab,52241,2578,52241,0,52241
04/02/2021,Punjab,56208,3967,56208,0,56208
05/02/2021,Punjab,60878,4670,60878,0,60878
06/02/2021,Punjab,64399,3521,64399,0,64399
07/02/2021,Punjab,64401,2,64401,0,64401
08/02/2021,Punjab,70250,5849,70250,0,70250
09/02/2021,Punjab,75851,5601,75851,0,75851
10/02/2021,Punjab,80350,4499,80350,0,80350
11/02/2021,Punjab,85911,5561,85911,0,85911
12/02/2021,Punjab,90012,4101,90012,0,90012
13/02/2021,Punjab,92050,2038,91988,62,91988
14/02/2021,Punjab,92050,0,91988,62,91988
15/02/2021,Punjab,97181,5131,96153,1028,96153
16/02/2021,Punjab,102258,5077,100270,1988,100270
17/02/2021,Punjab,106279,4021,103601,2678,103601
18/02/2021,Punjab,107749,1470,102775,4974,102775
19/02/2021,Punjab,122526,14777,113959,8567,113959
20/02/2021,Punjab,128999,6473,116708,12291,116708
21/02/2021,Punjab,129510,511,116815,12695,116815
22/02/2021,Punjab,140314,10804,121967,18347,121967
23/02/2021,Punjab,149544,9230,128224,21320,128224
24/02/2021,Punjab,158632,9088,134183,24449,134183
25/02/2021,Punjab,172597,13965,143306,29291,143306
26/02/2021,Punjab,181693,9096,149199,32494,149199
27/02/2021,Punjab,181693,0,149199,32494,149199
28/02/2021,Punjab,181693,0,149199,32494,149199
01/03/2021,Punjab,181693,0,149199,32494,149199
02/03/2021,Punjab,199021,17328,163048,35973,163048
03/03/2021,Punjab,211462,12441,173112,38350,173112
04/03/2021,Punjab,224386,12924,183847,40539,183847
05/03/2021,Punjab,240500,16114,197223,43277,197223
06/03/2021,Punjab,254347,13847,208515,45832,208515
07/03/2021,Punjab,255858,1511,209935,45923,209935
08/03/2021,Punjab,275759,19901,226539,49220,226539
09/03/2021,Punjab,246839,-28920,193804,53035,246839
10/03/2021,Punjab,263332,16493,207008,56324,263332
11/03/2021,Punjab,269729,6397,212869,56860,269729
12/03/2021,Punjab,289983,20254,228580,61403,289983
13/03/2021,Punjab,308567,18584,243904,64663,308567
14/03/2021,Punjab,311048,2481,246290,64758,311048
15/03/2021,Punjab,335644,24596,266837,68807,335644
16/03/2021,Punjab,411080,75436,338578,72502,338578
17/03/2021,Punjab,466103,55023,390818,75285,390818
18/03/2021,Punjab,496341,30238,417939,78402,417939
19/03/2021,Punjab,530257,33916,448570,81687,448570
20/03/2021,Punjab,567812,37555,483574,84238,483574
21/03/2021,Punjab,578775,10963,494076,84699,494076
22/03/2021,Punjab,613264,34489,525293,87971,525293
23/03/2021,Punjab,649345,36081,558275,91070,558275
24/03/2021,Punjab,681673,32328,588402,93271,588402
25/03/2021,Punjab,719040,37367,623062,95978,623062
26/03/2021,Punjab,755002,35962,657164,97838,657164
27/03/2021,Punjab,802200,47198,702391,99809,702391
28/03/2021,Punjab,821912,19712,721557,100355,721557
29/03/2021,Punjab,842376,20464,741177,101199,741177
30/03/2021,Punjab,892969,50593,788634,104335,788634
31/03/2021,Punjab,944534,51565,836310,108224,836310
01/04/2021,Punjab,1004421,59887,892880,111541,892880
02/04/2021,Punjab,1076831,72410,961706,115125,961706
03/04/2021,Punjab,1152514,75683,1033601,118913,1033601
04/04/2021,Punjab,1237974,85460,1116418,121556,1116418
05/04/2021,Punjab,1310252,72278,1184561,125691,1184561
06/04/2021,Punjab,1354171,43919,1226129,128042,1226129
07/04/2021,Punjab,1469287,115116,1334736,134551,1334736
08/04/2021,Punjab,1570863,101576,1430914,139949,1430914
09/04/2021,Punjab,1672525,101662,1526823,145702,1526823
10/04/2021,Punjab,1769540,97015,1618233,151307,1618233
11/04/2021,Punjab,1844914,75374,1690799,154115,1690799
12/04/2021,Punjab,1938682,93768,1776693,161989,1776693
13/04/2021,Punjab,2002350,63668,1835859,166491,1835859
14/04/2021,Punjab,2080326,77976,1907408,172918,1907408
15/04/2021,Punjab,2165009,84683,1981682,183327,1981682
16/04/2021,Punjab,2261353,96344,2066797,194556,2066797
17/04/2021,Punjab,2352247,90894,2145690,206557,2145690
18/04/2021,Punjab,2418071,65824,2205031,213040,2205031
19/04/2021,Punjab,2507520,89449,2279891,227629,2279891
20/04/2021,Punjab,2594737,87217,2352465,242272,2352465
21/04/2021,Punjab,2657654,62917,2403286,254368,2403286
22/04/2021,Punjab,2714945,57291,2448621,266324,2448621
23/04/2021,Punjab,2811886,96941,2526188,285698,2526188
24/04/2021,Punjab,2924267,112381,2616660,307607,2616660
25/04/2021,Punjab,2995036,70769,2676116,318920,2676116
26/04/2021,Punjab,3085641,90605,2746637,339004,2746637
27/04/2021,Punjab,3131430,45789,2779190,352240,2779190
28/04/2021,Punjab,3211403,79973,2837315,374088,2837315
29/04/2021,Punjab,3292863,81460,2896032,396831,2896032
30/04/2021,Punjab,3394080,101217,2968888,425192,2968888
01/05/2021,Punjab,3465616,71536,3022501,443115,3022501
02/05/2021,Punjab,3498524,32908,3047712,450812,3047712
03/05/2021,Punjab,3535078,36554,3073058,462020,3073058
04/05/2021,Punjab,3556000,20922,3087605,468395,3087605
05/05/2021,Punjab,3636037,80037,3137052,498985,3137052
06/05/2021,Punjab,3718025,81988,3189159,528866,3189159
07/05/2021,Punjab,3790968,72943,3234007,556961,3234007
08/05/2021,Punjab,3859741,68773,3273867,585874,3273867
09/05/2021,Punjab,3900797,41056,3298768,602029,3298768
10/05/2021,Punjab,3981861,81064,3343731,638130,3343731
11/05/2021,Punjab,4065354,83493,3392970,672384,3392970
12/05/2021,Punjab,4117718,52364,3430867,686851,3430867
13/05/2021,Punjab,4157568,39850,3460222,697346,3460222
14/05/2021,Punjab,4176283,18715,3474171,702112,3474171
15/05/2021,Punjab,4195166,18883,3488899,706267,3488899
16/05/2021,Punjab,4200672,5506,3493453,707219,3493453
17/05/2021,Punjab,4209769,9097,3500885,708884,3500885
18/05/2021,Punjab,4218012,8243,3506609,711403,3506609
19/05/2021,Punjab,4239354,21342,3526147,713207,3526147
20/05/2021,Punjab,4277807,38453,3561644,716163,3561644
21/05/2021,Punjab,4315486,37679,3594976,720510,3594976
22/05/2021,Punjab,4370063,54577,3643648,726415,3643648
23/05/2021,Punjab,4395438,25375,3664812,730626,3664812
24/05/2021,Punjab,4422709,27271,3686593,736116,3686593
25/05/2021,Punjab,4449172,26463,3704760,744412,3704760
26/05/2021,Punjab,4481288,32116,3732629,748659,3732629
27/05/2021,Punjab,4505298,24010,3752636,752662,3752636
28/05/2021,Punjab,4524754,19456,3768211,756543,3768211
29/05/2021,Punjab,4568745,43991,3807020,761725,3807020
30/05/2021,Punjab,4602591,33846,3837481,765110,3837481
31/05/2021,Punjab,4639262,36671,3868801,770461,3868801
01/06/2021,Punjab,4675210,35948,3899387,775823,3899387
02/06/2021,Punjab,4712161,36951,3932229,779932,3932229
03/06/2021,Punjab,4749239,37078,3965188,784051,3965188
04/06/2021,Punjab,4809245,60006,4020410,788835,4020410
05/06/2021,Punjab,4872289,63044,4079301,792988,4079301
06/06/2021,Punjab,4911988,39699,4117141,794847,4117141
07/06/2021,Punjab,4962200,50212,4163128,799072,4163128
08/06/2021,Punjab,5010368,48168,4207220,803148,4207220
09/06/2021,Punjab,5041984,31616,4236020,805964,4236020
10/06/2021,Punjab,5070549,28565,4261364,809185,4261364
11/06/2021,Punjab,5123208,52659,4309836,813372,4309836
12/06/2021,Punjab,5187108,63900,4370081,817027,4370081
13/06/2021,Punjab,5219611,32503,4400382,819229,4400382
14/06/2021,Punjab,5246782,27171,4424663,822119,4424663
15/06/2021,Punjab,5277700,30918,4450734,826966,4450734
16/06/2021,Punjab,5299801,22101,4468606,831195,4468606
17/06/2021,Punjab,5327778,27977,4490513,837265,4490513
18/06/2021,Punjab,5356568,28790,4513149,843419,4513149
19/06/2021,Punjab,5385524,28956,4535431,850093,4535431
20/06/2021,Punjab,5422887,37363,4565935,856952,4565935
21/06/2021,Punjab,5521994,99107,4654728,867266,4654728
22/06/2021,Punjab,5647031,125037,4764482,882549,4764482
23/06/2021,Punjab,5736250,89219,4839891,896359,4839891
24/06/2021,Punjab,5844271,108021,4929959,914312,4929959
25/06/2021,Punjab,5972116,127845,5036271,935845,
26/06/2021,Punjab,6114078,141962,5146916,967162,
27/06/2021,Punjab,6182574,68496,5204384,978190,
28/06/2021,Punjab,6230597,48023,5242562,988035,
29/06/2021,Punjab,6265875,35278,5269832,996043,
30/06/2021,Punjab,6292478,26603,5289807,1002671,
01/07/2021,Punjab,6314228,21750,5307013,1007215,
02/07/2021,Punjab,6346355,32127,5327984,1018371,
03/07/2021,Punjab,6894264,547909,5710932,1183332,
04/07/2021,Punjab,7017721,123457,5800293,1217428,
05/07/2021,Punjab,7070442,52721,5835504,1234938,
06/07/2021,Punjab,7095644,25202,5853013,1242631,
07/07/2021,Punjab,7290636,194992,5977846,1312790,
08/07/2021,Punjab,7317865,27229,5994518,1323347,
09/07/2021,Punjab,7331991,14126,6002896,1329095,
10/07/2021,Punjab,7387130,55139,6045372,1341758,
11/07/2021,Punjab,7415803,28673,6070212,1345591,
12/07/2021,Punjab,7618925,203122,6190246,1428679,
13/07/2021,Punjab,7664312,45387,6217365,1446947,
14/07/2021,Punjab,7797266,132954,6339924,1457342,
15/07/2021,Punjab,7822491,25225,6358671,1463820,
16/07/2021,Punjab,8002865,180374,6465498,1537367,
17/07/2021,Punjab,8035894,33029,6485454,1550440,
18/07/2021,Punjab,8041864,5970,6488932,1552932,
19/07/2021,Punjab,8055801,13937,6497157,1558644,
20/07/2021,Punjab,8066359,10558,6503408,1562951,
21/07/2021,Punjab,8261290,194931,6615594,1645696,
22/07/2021,Punjab,8322119,60829,6647300,1674819,
23/07/2021,Punjab,8345882,23763,6659008,1686874,
24/07/2021,Punjab,8469949,124067,6719588,1750361,
25/07/2021,Punjab,8494820,24871,6731924,1762896,
26/07/2021,Punjab,8523555,28735,6747639,1775916,
27/07/2021,Punjab,8542425,18870,6757301,1785124,
28/07/2021,Punjab,8637626,95201,6806417,1831209,
29/07/2021,Punjab,8751968,114342,6868957,1883011,
30/07/2021,Punjab,8893061,141093,6948236,1944825,
31/07/2021,Punjab,9155481,262420,7192206,1963275,
01/08/2021,Punjab,9614710,459229,7596875,2017835,
02/08/2021,Punjab,9691969,77259,7641792,2050177,
03/08/2021,Punjab,9758467,66498,7683148,2075319,
04/08/2021,Punjab,9794976,36509,7705110,2089866,
05/08/2021,Punjab,9827360,32384,7726279,2101081,
06/08/2021,Punjab,9854254,26894,7743609,2110645,
07/08/2021,Punjab,10064017,209763,7861095,2202922,
08/08/2021,Punjab,10140971,76954,7908348,2232623,
09/08/2021,Punjab,10291265,150294,8005636,2285629,
,,,,,,
,,,,,,
,,,,,,
,,,,,,
,,,,,,
,,,,,,
16/01/2021,Rajasthan,3285,3285,3285,0,3285
17/01/2021,Rajasthan,3455,170,3455,0,3455
18/01/2021,Rajasthan,4037,582,4037,0,4037
19/01/2021,Rajasthan,13022,8985,13022,0,13022
20/01/2021,Rajasthan,13146,124,13146,0,13146
21/01/2021,Rajasthan,13605,459,13605,0,13605
22/01/2021,Rajasthan,24545,10940,24545,0,24545
23/01/2021,Rajasthan,47915,23370,47915,0,47915
24/01/2021,Rajasthan,74727,26812,74727,0,74727
25/01/2021,Rajasthan,141245,66518,141245,0,141245
26/01/2021,Rajasthan,141527,282,141527,0,141527
27/01/2021,Rajasthan,218831,77304,218831,0,218831
28/01/2021,Rajasthan,239877,21046,239877,0,239877
29/01/2021,Rajasthan,302265,62388,302265,0,302265
30/01/2021,Rajasthan,307923,5658,307923,0,307923
31/01/2021,Rajasthan,309565,1642,309565,0,309565
01/02/2021,Rajasthan,313321,3756,313321,0,313321
02/02/2021,Rajasthan,319352,6031,319352,0,319352
03/02/2021,Rajasthan,343265,23913,343265,0,343265
04/02/2021,Rajasthan,364452,21187,364452,0,364452
05/02/2021,Rajasthan,392138,27686,392138,0,392138
06/02/2021,Rajasthan,434782,42644,434782,0,434782
07/02/2021,Rajasthan,436384,1602,436384,0,436384
08/02/2021,Rajasthan,462139,25755,462139,0,462139
09/02/2021,Rajasthan,467360,5221,467360,0,467360
10/02/2021,Rajasthan,534459,67099,534459,0,534459
11/02/2021,Rajasthan,566165,31706,566165,0,566165
12/02/2021,Rajasthan,582386,16221,582386,0,582386
13/02/2021,Rajasthan,585570,3184,585570,0,585570
14/02/2021,Rajasthan,586110,540,586110,0,586110
15/02/2021,Rajasthan,611493,25383,603314,8179,603314
16/02/2021,Rajasthan,626481,14988,612615,13866,612615
17/02/2021,Rajasthan,747482,121001,732921,14561,732921
18/02/2021,Rajasthan,732405,-15077,717526,14879,717526
19/02/2021,Rajasthan,790236,57831,772221,18015,772221
20/02/2021,Rajasthan,810063,19827,773238,36825,773238
21/02/2021,Rajasthan,810077,14,773239,36838,773239
22/02/2021,Rajasthan,836494,26417,773521,62973,773521
23/02/2021,Rajasthan,866185,29691,774043,92142,774043
24/02/2021,Rajasthan,919887,53702,774498,145389,774498
25/02/2021,Rajasthan,939812,19925,788094,151718,788094
26/02/2021,Rajasthan,1010420,70608,789478,220942,789478
27/02/2021,Rajasthan,1010420,0,789478,220942,789478
28/02/2021,Rajasthan,1010422,2,789480,220942,789480
01/03/2021,Rajasthan,1010422,0,789480,220942,789480
02/03/2021,Rajasthan,1213860,203438,963857,250003,963857
03/03/2021,Rajasthan,1423769,209909,1160351,263418,1160351
04/03/2021,Rajasthan,1532359,108590,1256310,276049,1256310
05/03/2021,Rajasthan,1783489,251130,1486399,297090,1486399
06/03/2021,Rajasthan,2024053,240564,1704633,319420,1704633
07/03/2021,Rajasthan,2037152,13099,1716982,320170,1716982
08/03/2021,Rajasthan,2225610,188458,1888485,337125,1888485
09/03/2021,Rajasthan,1960495,-265115,1603603,356892,1960495
10/03/2021,Rajasthan,2085412,124917,1685982,399430,2085412
11/03/2021,Rajasthan,2089766,4354,1689250,400516,2089766
12/03/2021,Rajasthan,2263958,174192,1834674,429284,2263958
13/03/2021,Rajasthan,2446510,182552,2002259,444251,2446510
14/03/2021,Rajasthan,2456156,9646,2011583,444573,2456156
15/03/2021,Rajasthan,2649046,192890,2190626,458420,2649046
16/03/2021,Rajasthan,3222996,573950,2751567,471429,2751567
17/03/2021,Rajasthan,3624763,401767,3045459,579304,3045459
18/03/2021,Rajasthan,3686399,61636,3093912,592487,3093912
19/03/2021,Rajasthan,3936959,250560,3315225,621734,3315225
20/03/2021,Rajasthan,4180576,243617,3546499,634077,3546499
21/03/2021,Rajasthan,4219462,38886,3584419,635043,3584419
22/03/2021,Rajasthan,4395920,176458,3755021,640899,3755021
23/03/2021,Rajasthan,4641690,245770,3995543,646147,3995543
24/03/2021,Rajasthan,4864027,222337,4213791,650236,4213791
25/03/2021,Rajasthan,4936175,72148,4282590,653585,4282590
26/03/2021,Rajasthan,5145466,209291,4487127,658339,4487127
27/03/2021,Rajasthan,5333240,187774,4671741,661499,4671741
28/03/2021,Rajasthan,5341604,8364,4680019,661585,4680019
29/03/2021,Rajasthan,5341595,-9,4680010,661585,4680010
30/03/2021,Rajasthan,5434584,92989,4756460,678124,4756460
31/03/2021,Rajasthan,5570248,135664,4866824,703424,4866824
01/04/2021,Rajasthan,5740300,170052,5013880,726420,5013880
02/04/2021,Rajasthan,6080050,339750,5313549,766501,5313549
03/04/2021,Rajasthan,6369889,289839,5568003,801886,5568003
04/04/2021,Rajasthan,6802269,432380,5958784,843485,5958784
05/04/2021,Rajasthan,7140844,338575,6257503,883341,6257503
06/04/2021,Rajasthan,7456232,315388,6542132,914100,6542132
07/04/2021,Rajasthan,8149121,692889,7175412,973709,7175412
08/04/2021,Rajasthan,8802577,653456,7767712,1034865,7767712
09/04/2021,Rajasthan,9242464,439887,8164413,1078051,8164413
10/04/2021,Rajasthan,9563597,321133,8448722,1114875,8448722
11/04/2021,Rajasthan,9715559,151962,8581755,1133804,8581755
12/04/2021,Rajasthan,9924376,208817,8758751,1165625,8758751
13/04/2021,Rajasthan,10080259,155883,8885930,1194329,8885930
14/04/2021,Rajasthan,10223602,143343,8996238,1227364,8996238
15/04/2021,Rajasthan,10357687,134085,9093355,1264332,9093355
16/04/2021,Rajasthan,10522686,164999,9206593,1316093,9206593
17/04/2021,Rajasthan,10696255,173569,9330653,1365602,9330653
18/04/2021,Rajasthan,10883172,186917,9457932,1425240,9457932
19/04/2021,Rajasthan,11190106,306934,9659550,1530556,9659550
20/04/2021,Rajasthan,11450316,260210,9828071,1622245,9828071
21/04/2021,Rajasthan,11649150,198834,9952126,1697024,9952126
22/04/2021,Rajasthan,11834881,185731,10068970,1765911,10068970
23/04/2021,Rajasthan,12009834,174953,10178146,1831688,10178146
24/04/2021,Rajasthan,12207116,197282,10298265,1908851,10298265
25/04/2021,Rajasthan,12347726,140610,10388394,1959332,10388394
26/04/2021,Rajasthan,12541830,194104,10507761,2034069,10507761
27/04/2021,Rajasthan,12659945,118115,10578840,2081105,10578840
28/04/2021,Rajasthan,12811445,151500,10669656,2141789,10669656
29/04/2021,Rajasthan,12936289,124844,10745384,2190905,10745384
30/04/2021,Rajasthan,13021948,85659,10797155,2224793,10797155
01/05/2021,Rajasthan,13084309,62361,10835900,2248409,10835900
02/05/2021,Rajasthan,13173409,89100,10894243,2279166,10894243
03/05/2021,Rajasthan,13351069,177660,11008158,2342911,11008158
04/05/2021,Rajasthan,13497182,146113,11108037,2389145,11108037
05/05/2021,Rajasthan,13626322,129140,11195379,2430943,11195379
06/05/2021,Rajasthan,13736919,110597,11266670,2470249,11266670
07/05/2021,Rajasthan,13891493,154574,11346992,2544501,11346992
08/05/2021,Rajasthan,14086593,195100,11435174,2651419,11435174
09/05/2021,Rajasthan,14177991,91398,11498654,2679337,11498654
10/05/2021,Rajasthan,14374162,196171,11636945,2737217,11636945
11/05/2021,Rajasthan,14626660,252498,11777805,2848855,11777805
12/05/2021,Rajasthan,14811519,184859,11907840,2903679,11907840
13/05/2021,Rajasthan,14934512,122993,11987039,2947473,11987039
14/05/2021,Rajasthan,14991949,57437,12027499,2964450,12027499
15/05/2021,Rajasthan,15135482,143533,12151403,2984079,12151403
16/05/2021,Rajasthan,15249948,114466,12264148,2985800,12264148
17/05/2021,Rajasthan,15414928,164980,12424705,2990223,12424705
18/05/2021,Rajasthan,15544817,129889,12550082,2994735,12550082
19/05/2021,Rajasthan,15625438,80621,12624961,3000477,12624961
20/05/2021,Rajasthan,15709931,84493,12703604,3006327,12703604
21/05/2021,Rajasthan,15819042,109111,12802925,3016117,12802925
22/05/2021,Rajasthan,15944503,125461,12918449,3026054,12918449
23/05/2021,Rajasthan,16036018,91515,13005679,3030339,13005679
24/05/2021,Rajasthan,16186100,150082,13146014,3040086,13146014
25/05/2021,Rajasthan,16287494,101394,13236338,3051156,13236338
26/05/2021,Rajasthan,16367035,79541,13307746,3059289,13307746
27/05/2021,Rajasthan,16429431,62396,13364120,3065311,13364120
28/05/2021,Rajasthan,16554847,125416,13476246,3078601,13476246
29/05/2021,Rajasthan,16759793,204946,13668689,3091104,13668689
30/05/2021,Rajasthan,16865658,105865,13767364,3098294,13767364
31/05/2021,Rajasthan,17016331,150673,13900165,3116166,13900165
01/06/2021,Rajasthan,17124031,107700,13990636,3133395,13990636
02/06/2021,Rajasthan,17240714,116683,14090093,3150621,14090093
03/06/2021,Rajasthan,17334159,93445,14169376,3164783,14169376
04/06/2021,Rajasthan,17488910,154751,14298417,3190493,14298417
05/06/2021,Rajasthan,17662091,173181,14444962,3217129,14444962
06/06/2021,Rajasthan,17743175,81084,14513474,3229701,14513474
07/06/2021,Rajasthan,17872011,128836,14615154,3256857,14615154
08/06/2021,Rajasthan,18040679,168668,14759272,3281407,14759272
09/06/2021,Rajasthan,18484841,444162,15186893,3297948,15186893
10/06/2021,Rajasthan,18832537,347696,15524081,3308456,15524081
11/06/2021,Rajasthan,19292726,460189,15970989,3321737,15970989
12/06/2021,Rajasthan,19606991,314265,16273082,3333909,16273082
13/06/2021,Rajasthan,19721553,114562,16383144,3338409,16383144
14/06/2021,Rajasthan,19895554,174001,16548285,3347269,16548285
15/06/2021,Rajasthan,19990335,94781,16636379,3353956,16636379
16/06/2021,Rajasthan,20042703,52368,16682442,3360261,16682442
17/06/2021,Rajasthan,20286459,243756,16920784,3365675,16920784
18/06/2021,Rajasthan,20630839,344380,17259146,3371693,17259146
19/06/2021,Rajasthan,20869269,238430,17479778,3389491,17479778
20/06/2021,Rajasthan,21238176,368907,17808082,3430094,17808082
21/06/2021,Rajasthan,21713044,474868,18233535,3479509,18233535
22/06/2021,Rajasthan,22139075,426031,18591445,3547630,18591445
23/06/2021,Rajasthan,22498043,358968,18905925,3592118,18905925
24/06/2021,Rajasthan,22714675,216632,19090259,3624416,19090259
25/06/2021,Rajasthan,23669169,954494,19929199,3739970,
26/06/2021,Rajasthan,23987142,317973,20190615,3796527,
27/06/2021,Rajasthan,24251293,264151,20412715,3838578,
28/06/2021,Rajasthan,24438759,187466,20555847,3882912,
29/06/2021,Rajasthan,24548916,110157,20634921,3913995,
30/06/2021,Rajasthan,24731046,182130,20750495,3980551,
01/07/2021,Rajasthan,24802226,71180,20795259,4006967,
02/07/2021,Rajasthan,24887697,85471,20857470,4030227,
03/07/2021,Rajasthan,25666108,778411,21329040,4337068,
04/07/2021,Rajasthan,25769650,103542,21401946,4367704,
05/07/2021,Rajasthan,25821446,51796,21436551,4384895,
06/07/2021,Rajasthan,25848234,26788,21454435,4393799,
07/07/2021,Rajasthan,25937520,89286,21492586,4444934,
08/07/2021,Rajasthan,26122903,185383,21575079,4547824,
09/07/2021,Rajasthan,26199280,76377,21609462,4589818,
10/07/2021,Rajasthan,26331376,132096,21664006,4667370,
11/07/2021,Rajasthan,26410483,79107,21723913,4686570,
12/07/2021,Rajasthan,26449059,38576,21746599,4702460,
13/07/2021,Rajasthan,26864455,415396,21932046,4932409,
14/07/2021,Rajasthan,27443343,578888,22338369,5104974,
15/07/2021,Rajasthan,27500600,57257,22373497,5127103,
16/07/2021,Rajasthan,27641745,141145,22426875,5214870,
17/07/2021,Rajasthan,28339982,698237,22825332,5514650,
18/07/2021,Rajasthan,28728054,388072,23104088,5623966,
19/07/2021,Rajasthan,29004440,276386,23295064,5709376,
20/07/2021,Rajasthan,29112114,107674,23366886,5745228,
21/07/2021,Rajasthan,29445345,333231,23537218,5908127,
22/07/2021,Rajasthan,29921633,476288,23791131,6130502,
23/07/2021,Rajasthan,30117597,195964,23882904,6234693,
24/07/2021,Rajasthan,30199259,81662,23920844,6278415,
25/07/2021,Rajasthan,30375699,176440,23957890,6417809,
26/07/2021,Rajasthan,30600816,225117,24030759,6570057,
27/07/2021,Rajasthan,30844855,244039,24135690,6709165,
28/07/2021,Rajasthan,31308628,463773,24360155,6948473,
29/07/2021,Rajasthan,31750352,441724,24540264,7210088,
30/07/2021,Rajasthan,32039895,289543,24701914,7337981,
31/07/2021,Rajasthan,32468620,428725,24972030,7496590,
01/08/2021,Rajasthan,32814367,345747,25283749,7530618,
02/08/2021,Rajasthan,33297593,483226,25550176,7747417,
03/08/2021,Rajasthan,33624206,326613,25761454,7862752,
04/08/2021,Rajasthan,33959663,335457,26005913,7953750,
05/08/2021,Rajasthan,34198362,238699,26169393,8028969,
06/08/2021,Rajasthan,34620302,421940,26474406,8145896,
07/08/2021,Rajasthan,34954868,334566,26710747,8244121,
08/08/2021,Rajasthan,35082922,128054,26797208,8285714,
09/08/2021,Rajasthan,35383662,300740,27008606,8375056,
,,,,,,
,,,,,,
,,,,,,
,,,,,,
,,,,,,
,,,,,,
16/01/2021,Sikkim,7,7,7,0,7
17/01/2021,Sikkim,7,0,7,0,7
18/01/2021,Sikkim,7,0,7,0,7
19/01/2021,Sikkim,38,31,38,0,38
20/01/2021,Sikkim,62,24,62,0,62
21/01/2021,Sikkim,186,124,186,0,186
22/01/2021,Sikkim,296,110,296,0,296
23/01/2021,Sikkim,299,3,299,0,299
24/01/2021,Sikkim,309,10,309,0,309
25/01/2021,Sikkim,477,168,477,0,477
26/01/2021,Sikkim,490,13,490,0,490
27/01/2021,Sikkim,964,474,964,0,964
28/01/2021,Sikkim,1431,467,1431,0,1431
29/01/2021,Sikkim,1707,276,1707,0,1707
30/01/2021,Sikkim,1707,0,1707,0,1707
31/01/2021,Sikkim,1709,2,1709,0,1709
01/02/2021,Sikkim,1855,146,1855,0,1855
02/02/2021,Sikkim,2336,481,2336,0,2336
03/02/2021,Sikkim,3084,748,3084,0,3084
04/02/2021,Sikkim,3923,839,3923,0,3923
05/02/2021,Sikkim,4857,934,4857,0,4857
06/02/2021,Sikkim,5089,232,5089,0,5089
07/02/2021,Sikkim,5090,1,5090,0,5090
08/02/2021,Sikkim,5726,636,5726,0,5726
09/02/2021,Sikkim,6653,927,6653,0,6653
10/02/2021,Sikkim,7478,825,7478,0,7478
11/02/2021,Sikkim,8022,544,8022,0,8022
12/02/2021,Sikkim,8041,19,8041,0,8041
13/02/2021,Sikkim,8042,1,8042,0,8042
14/02/2021,Sikkim,8042,0,8042,0,8042
15/02/2021,Sikkim,8252,210,8252,0,8252
16/02/2021,Sikkim,9006,754,8849,157,8849
17/02/2021,Sikkim,9714,708,9463,251,9463
18/02/2021,Sikkim,10339,625,9981,358,9981
19/02/2021,Sikkim,11993,1654,11296,697,11296
20/02/2021,Sikkim,12921,928,12222,699,12222
21/02/2021,Sikkim,12921,0,12222,699,12222
22/02/2021,Sikkim,14550,1629,13766,784,13766
23/02/2021,Sikkim,16146,1596,15194,952,15194
24/02/2021,Sikkim,17456,1310,16382,1074,16382
25/02/2021,Sikkim,18535,1079,17286,1249,17286
26/02/2021,Sikkim,19112,577,17647,1465,17647
27/02/2021,Sikkim,19112,0,17647,1465,17647
28/02/2021,Sikkim,19112,0,17647,1465,17647
01/03/2021,Sikkim,19112,0,17647,1465,17647
02/03/2021,Sikkim,20991,1879,18890,2101,18890
03/03/2021,Sikkim,22602,1611,20235,2367,20235
04/03/2021,Sikkim,24622,2020,21853,2769,21853
05/03/2021,Sikkim,27446,2824,23624,3822,23624
06/03/2021,Sikkim,29477,2031,25221,4256,25221
07/03/2021,Sikkim,29477,0,25221,4256,25221
08/03/2021,Sikkim,33038,3561,27834,5204,27834
09/03/2021,Sikkim,30915,-2123,24975,5940,30915
10/03/2021,Sikkim,34629,3714,28118,6511,34629
11/03/2021,Sikkim,38361,3732,31053,7308,38361
12/03/2021,Sikkim,41096,2735,33511,7585,41096
13/03/2021,Sikkim,41351,255,33766,7585,41351
14/03/2021,Sikkim,41351,0,33766,7585,41351
15/03/2021,Sikkim,44207,2856,36344,7863,44207
16/03/2021,Sikkim,50954,6747,42816,8138,42816
17/03/2021,Sikkim,54631,3677,46124,8507,46124
18/03/2021,Sikkim,57312,2681,48290,9022,48290
19/03/2021,Sikkim,59889,2577,50370,9519,50370
20/03/2021,Sikkim,61649,1760,51788,9861,51788
21/03/2021,Sikkim,61716,67,51854,9862,51854
22/03/2021,Sikkim,64495,2779,53523,10972,53523
23/03/2021,Sikkim,67281,2786,55534,11747,55534
24/03/2021,Sikkim,69288,2007,57257,12031,57257
25/03/2021,Sikkim,71024,1736,58846,12178,58846
26/03/2021,Sikkim,72788,1764,60509,12279,60509
27/03/2021,Sikkim,72814,26,60535,12279,60535
28/03/2021,Sikkim,72815,1,60536,12279,60536
29/03/2021,Sikkim,72815,0,60536,12279,60536
30/03/2021,Sikkim,73752,937,61317,12435,61317
31/03/2021,Sikkim,74191,439,61697,12494,61697
01/04/2021,Sikkim,77314,3123,64678,12636,64678
02/04/2021,Sikkim,78293,979,65631,12662,65631
03/04/2021,Sikkim,78880,587,66218,12662,66218
04/04/2021,Sikkim,79192,312,66530,12662,66530
05/04/2021,Sikkim,82059,2867,69217,12842,69217
06/04/2021,Sikkim,85747,3688,72723,13024,72723
07/04/2021,Sikkim,94426,8679,80892,13534,80892
08/04/2021,Sikkim,104473,10047,90081,14392,90081
09/04/2021,Sikkim,112414,7941,97386,15028,97386
10/04/2021,Sikkim,115201,2787,99963,15238,99963
11/04/2021,Sikkim,117171,1970,101795,15376,101795
12/04/2021,Sikkim,125831,8660,109886,15945,109886
13/04/2021,Sikkim,135455,9624,118962,16493,118962
14/04/2021,Sikkim,141777,6322,124532,17245,124532
15/04/2021,Sikkim,148555,6778,130118,18437,130118
16/04/2021,Sikkim,155241,6686,135490,19751,135490
17/04/2021,Sikkim,160123,4882,139394,20729,139394
18/04/2021,Sikkim,161058,935,140119,20939,140119
19/04/2021,Sikkim,166609,5551,143952,22657,143952
20/04/2021,Sikkim,171123,4514,146868,24255,146868
21/04/2021,Sikkim,172465,1342,147787,24678,147787
22/04/2021,Sikkim,177162,4697,149886,27276,149886
23/04/2021,Sikkim,182621,5459,152278,30343,152278
24/04/2021,Sikkim,185449,2828,153579,31870,153579
25/04/2021,Sikkim,185895,446,153939,31956,153939
26/04/2021,Sikkim,189953,4058,155696,34257,155696
27/04/2021,Sikkim,193834,3881,157168,36666,157168
28/04/2021,Sikkim,196919,3085,158440,38479,158440
29/04/2021,Sikkim,200586,3667,159827,40759,159827
30/04/2021,Sikkim,203966,3380,161083,42883,161083
01/05/2021,Sikkim,204960,994,161364,43596,161364
02/05/2021,Sikkim,204990,30,161376,43614,161376
03/05/2021,Sikkim,207754,2764,162016,45738,162016
04/05/2021,Sikkim,210281,2527,162666,47615,162666
05/05/2021,Sikkim,212688,2407,163194,49494,163194
06/05/2021,Sikkim,215456,2768,164073,51383,164073
07/05/2021,Sikkim,218368,2912,164598,53770,164598
08/05/2021,Sikkim,219141,773,164772,54369,164772
09/05/2021,Sikkim,219312,171,164805,54507,164805
10/05/2021,Sikkim,221248,1936,165201,56047,165201
11/05/2021,Sikkim,222448,1200,165440,57008,165440
12/05/2021,Sikkim,223154,706,165669,57485,165669
13/05/2021,Sikkim,224984,1830,165948,59036,165948
14/05/2021,Sikkim,225702,718,166119,59583,166119
15/05/2021,Sikkim,225794,92,166200,59594,166200
16/05/2021,Sikkim,226156,362,166562,59594,166562
17/05/2021,Sikkim,226891,735,167276,59615,167276
18/05/2021,Sikkim,227622,731,168003,59619,168003
19/05/2021,Sikkim,229107,1485,169488,59619,169488
20/05/2021,Sikkim,230980,1873,171357,59623,171357
21/05/2021,Sikkim,232718,1738,173083,59635,173083
22/05/2021,Sikkim,234303,1585,174666,59637,174666
23/05/2021,Sikkim,234303,0,174666,59637,174666
24/05/2021,Sikkim,235593,1290,175956,59637,175956
25/05/2021,Sikkim,236874,1281,177233,59641,177233
26/05/2021,Sikkim,237959,1085,178318,59641,178318
27/05/2021,Sikkim,238715,756,179072,59643,179072
28/05/2021,Sikkim,238828,113,179180,59648,179180
29/05/2021,Sikkim,238891,63,179238,59653,179238
30/05/2021,Sikkim,238891,0,179238,59653,179238
31/05/2021,Sikkim,238983,92,179322,59661,179322
01/06/2021,Sikkim,239043,60,179370,59673,179370
02/06/2021,Sikkim,239174,131,179483,59691,179483
03/06/2021,Sikkim,239355,181,179658,59697,179658
04/06/2021,Sikkim,239548,193,179835,59713,179835
05/06/2021,Sikkim,239628,80,179914,59714,179914
06/06/2021,Sikkim,239779,151,180065,59714,180065
07/06/2021,Sikkim,240036,257,180310,59726,180310
08/06/2021,Sikkim,240711,675,180973,59738,180973
09/06/2021,Sikkim,244354,3643,184590,59764,184590
10/06/2021,Sikkim,252346,7992,192568,59778,192568
11/06/2021,Sikkim,264968,12622,205177,59791,205177
12/06/2021,Sikkim,273389,8421,213590,59799,213590
13/06/2021,Sikkim,273567,178,213768,59799,213768
14/06/2021,Sikkim,286462,12895,226626,59836,226626
15/06/2021,Sikkim,302373,15911,242535,59838,242535
16/06/2021,Sikkim,317335,14962,257485,59850,257485
17/06/2021,Sikkim,331827,14492,271946,59881,271946
18/06/2021,Sikkim,347391,15564,287492,59899,287492
19/06/2021,Sikkim,358633,11242,298722,59911,298722
20/06/2021,Sikkim,359435,802,299524,59911,299524
21/06/2021,Sikkim,371403,11968,311460,59943,311460
22/06/2021,Sikkim,385331,13928,325348,59983,325348
23/06/2021,Sikkim,397182,11851,337151,60031,337151
24/06/2021,Sikkim,409995,12813,349190,60805,349190
25/06/2021,Sikkim,423563,13568,362037,61526,
26/06/2021,Sikkim,433131,9568,371534,61597,
27/06/2021,Sikkim,433136,5,371539,61597,
28/06/2021,Sikkim,448770,15634,384196,64574,
29/06/2021,Sikkim,462454,13684,394505,67949,
30/06/2021,Sikkim,473810,11356,401506,72304,
01/07/2021,Sikkim,483470,9660,407286,76184,
02/07/2021,Sikkim,493534,10064,411724,81810,
03/07/2021,Sikkim,501578,8044,416397,85181,
04/07/2021,Sikkim,501580,2,416397,85183,
05/07/2021,Sikkim,515248,13668,423054,92194,
06/07/2021,Sikkim,527470,12222,428512,98958,
07/07/2021,Sikkim,537467,9997,432987,104480,
08/07/2021,Sikkim,546775,9308,436734,110041,
09/07/2021,Sikkim,556100,9325,440417,115683,
10/07/2021,Sikkim,560587,4487,442125,118462,
11/07/2021,Sikkim,560587,0,442125,118462,
12/07/2021,Sikkim,570245,9658,445999,124246,
13/07/2021,Sikkim,572209,1964,447174,125035,
14/07/2021,Sikkim,576624,4415,451037,125587,
15/07/2021,Sikkim,586083,9459,455475,130608,
16/07/2021,Sikkim,595976,9893,461643,134333,
17/07/2021,Sikkim,600482,4506,464383,136099,
18/07/2021,Sikkim,600616,134,464508,136108,
19/07/2021,Sikkim,602701,2085,465924,136777,
20/07/2021,Sikkim,610184,7483,471162,139022,
21/07/2021,Sikkim,615158,4974,474356,140802,
22/07/2021,Sikkim,619709,4551,477661,142048,
23/07/2021,Sikkim,624999,5290,481112,143887,
24/07/2021,Sikkim,626545,1546,482041,144504,
25/07/2021,Sikkim,626545,0,482041,144504,
26/07/2021,Sikkim,630016,3471,484753,145263,
27/07/2021,Sikkim,632688,2672,486553,146135,
28/07/2021,Sikkim,633927,1239,487514,146413,
29/07/2021,Sikkim,635789,1862,488841,146948,
30/07/2021,Sikkim,637950,2161,490105,147845,
31/07/2021,Sikkim,638736,786,490631,148105,
01/08/2021,Sikkim,639327,591,491205,148122,
02/08/2021,Sikkim,642176,2849,493353,148823,
03/08/2021,Sikkim,643576,1400,494089,149487,
04/08/2021,Sikkim,644762,1186,494904,149858,
05/08/2021,Sikkim,646220,1458,495935,150285,
06/08/2021,Sikkim,647540,1320,496921,150619,
07/08/2021,Sikkim,647897,357,497154,150743,
08/08/2021,Sikkim,647897,0,497154,150743,
09/08/2021,Sikkim,649389,1492,497851,151538,
,,,,,,
,,,,,,
,,,,,,
,,,,,,
,,,,,,
,,,,,,
16/01/2021,Tamil Nadu,1167,1167,1167,0,1167
17/01/2021,Tamil Nadu,1745,578,1745,0,1745
18/01/2021,Tamil Nadu,2861,1116,2861,0,2861
19/01/2021,Tamil Nadu,6154,3293,6154,0,6154
20/01/2021,Tamil Nadu,9060,2906,9060,0,9060
21/01/2021,Tamil Nadu,15654,6594,15654,0,15654
22/01/2021,Tamil Nadu,23659,8005,23659,0,23659
23/01/2021,Tamil Nadu,31127,7468,31127,0,31127
24/01/2021,Tamil Nadu,35144,4017,35144,0,35144
25/01/2021,Tamil Nadu,41396,6252,41396,0,41396
26/01/2021,Tamil Nadu,46310,4914,46310,0,46310
27/01/2021,Tamil Nadu,54195,7885,54195,0,54195
28/01/2021,Tamil Nadu,61290,7095,61290,0,61290
29/01/2021,Tamil Nadu,66918,5628,66918,0,66918
30/01/2021,Tamil Nadu,76934,10016,76934,0,76934
31/01/2021,Tamil Nadu,77809,875,77809,0,77809
01/02/2021,Tamil Nadu,85002,7193,85002,0,85002
02/02/2021,Tamil Nadu,91094,6092,91094,0,91094
03/02/2021,Tamil Nadu,98750,7656,98750,0,98750
04/02/2021,Tamil Nadu,107904,9154,107904,0,107904
05/02/2021,Tamil Nadu,116857,8953,116857,0,116857
06/02/2021,Tamil Nadu,126381,9524,126381,0,126381
07/02/2021,Tamil Nadu,127289,908,127289,0,127289
08/02/2021,Tamil Nadu,139024,11735,139024,0,139024
09/02/2021,Tamil Nadu,150915,11891,150915,0,150915
10/02/2021,Tamil Nadu,162412,11497,162412,0,162412
11/02/2021,Tamil Nadu,173368,10956,173368,0,173368
12/02/2021,Tamil Nadu,184565,11197,184565,0,184565
13/02/2021,Tamil Nadu,195870,11305,195203,667,195203
14/02/2021,Tamil Nadu,196467,597,195796,671,195796
15/02/2021,Tamil Nadu,205097,8630,203921,1176,203921
16/02/2021,Tamil Nadu,215964,10867,213823,2141,213823
17/02/2021,Tamil Nadu,227737,11773,224158,3579,224158
18/02/2021,Tamil Nadu,234412,6675,228388,6024,228388
19/02/2021,Tamil Nadu,256388,21976,246203,10185,246203
20/02/2021,Tamil Nadu,269873,13485,255918,13955,255918
21/02/2021,Tamil Nadu,270487,614,256365,14122,256365
22/02/2021,Tamil Nadu,280847,10360,262213,18634,262213
23/02/2021,Tamil Nadu,291582,10735,268486,23096,268486
24/02/2021,Tamil Nadu,300604,9022,273618,26986,273618
25/02/2021,Tamil Nadu,308895,8291,278432,30463,278432
26/02/2021,Tamil Nadu,319966,11071,284640,35326,284640
27/02/2021,Tamil Nadu,319966,0,284640,35326,284640
28/02/2021,Tamil Nadu,319966,0,284640,35326,284640
01/03/2021,Tamil Nadu,319966,0,284640,35326,284640
02/03/2021,Tamil Nadu,357600,37634,315543,42057,315543
03/03/2021,Tamil Nadu,400506,42906,353429,47077,353429
04/03/2021,Tamil Nadu,455609,55103,404222,51387,404222
05/03/2021,Tamil Nadu,532154,76545,474441,57713,474441
06/03/2021,Tamil Nadu,619615,87461,554443,65172,554443
07/03/2021,Tamil Nadu,646341,26726,579008,67333,579008
08/03/2021,Tamil Nadu,732192,85851,658443,73749,658443
09/03/2021,Tamil Nadu,733464,1272,651487,81977,733464
10/03/2021,Tamil Nadu,820208,86744,729539,90669,820208
11/03/2021,Tamil Nadu,905294,85086,805176,100118,905294
12/03/2021,Tamil Nadu,996547,91253,887006,109541,996547
13/03/2021,Tamil Nadu,1086617,90070,967045,119572,1086617
14/03/2021,Tamil Nadu,1108284,21667,987144,121140,1108284
15/03/2021,Tamil Nadu,1205503,97219,1075960,129543,1205503
16/03/2021,Tamil Nadu,1423843,218340,1282816,141027,1282816
17/03/2021,Tamil Nadu,1581558,157715,1429800,151758,1429800
18/03/2021,Tamil Nadu,1695339,113781,1533516,161823,1533516
19/03/2021,Tamil Nadu,1814949,119610,1642080,172869,1642080
20/03/2021,Tamil Nadu,1941168,126219,1757406,183762,1757406
21/03/2021,Tamil Nadu,1988556,47388,1801246,187310,1801246
22/03/2021,Tamil Nadu,2085366,96810,1889774,195592,1889774
23/03/2021,Tamil Nadu,2217917,132551,2011826,206091,2011826
24/03/2021,Tamil Nadu,2317475,99558,2105533,211942,2105533
25/03/2021,Tamil Nadu,2422220,104745,2204055,218165,2204055
26/03/2021,Tamil Nadu,2527792,105572,2302650,225142,2302650
27/03/2021,Tamil Nadu,2632190,104398,2401267,230923,2401267
28/03/2021,Tamil Nadu,2653179,20989,2421436,231743,2421436
29/03/2021,Tamil Nadu,2748044,94865,2509568,238476,2509568
30/03/2021,Tamil Nadu,2829551,81507,2583284,246267,2583284
31/03/2021,Tamil Nadu,2905435,75884,2650411,255024,2650411
01/04/2021,Tamil Nadu,2965312,59877,2703180,262132,2703180
02/04/2021,Tamil Nadu,3046904,81592,2774534,272370,2774534
03/04/2021,Tamil Nadu,3101889,54985,2821427,280462,2821427
04/04/2021,Tamil Nadu,3141884,39995,2855222,286662,2855222
05/04/2021,Tamil Nadu,3187087,45203,2892174,294913,2892174
06/04/2021,Tamil Nadu,3219359,32272,2918808,300551,2918808
07/04/2021,Tamil Nadu,3280537,61178,2967647,312890,2967647
08/04/2021,Tamil Nadu,3400924,120387,3061151,339773,3061151
09/04/2021,Tamil Nadu,3532446,131522,3166812,365634,3166812
10/04/2021,Tamil Nadu,3665295,132849,3274164,391131,3274164
11/04/2021,Tamil Nadu,3714682,49387,3316055,398627,3316055
12/04/2021,Tamil Nadu,3880228,165546,3449290,430938,3449290
13/04/2021,Tamil Nadu,4019326,139098,3565954,453372,3565954
14/04/2021,Tamil Nadu,4110125,90799,3641043,469082,3641043
15/04/2021,Tamil Nadu,4315785,205660,3801731,514054,3801731
16/04/2021,Tamil Nadu,4528836,213051,3966587,562249,3966587
17/04/2021,Tamil Nadu,4669044,140208,4063643,605401,4063643
18/04/2021,Tamil Nadu,4710862,41818,4090953,619909,4090953
19/04/2021,Tamil Nadu,4813376,102514,4147072,666304,4147072
20/04/2021,Tamil Nadu,4892064,78688,4187565,704499,4187565
21/04/2021,Tamil Nadu,4965564,73500,4223251,742313,4223251
22/04/2021,Tamil Nadu,5075681,110117,4268889,806792,4268889
23/04/2021,Tamil Nadu,5205556,129875,4323326,882230,4323326
24/04/2021,Tamil Nadu,5327915,122359,4376661,951254,4376661
25/04/2021,Tamil Nadu,5351073,23158,4388384,962689,4388384
26/04/2021,Tamil Nadu,5483332,132259,4440291,1043041,4440291
27/04/2021,Tamil Nadu,5624732,141400,4495630,1129102,4495630
28/04/2021,Tamil Nadu,5740648,115916,4544279,1196369,4544279
29/04/2021,Tamil Nadu,5845197,104549,4589747,1255450,4589747
30/04/2021,Tamil Nadu,5947056,101859,4635084,1311972,4635084
01/05/2021,Tamil Nadu,6030884,83828,4671707,1359177,4671707
02/05/2021,Tamil Nadu,6046415,15531,4679335,1367080,4679335
03/05/2021,Tamil Nadu,6135244,88829,4716835,1418409,4716835
04/05/2021,Tamil Nadu,6210666,75422,4750360,1460306,4750360
05/05/2021,Tamil Nadu,6279062,68396,4781479,1497583,4781479
06/05/2021,Tamil Nadu,6379188,100126,4823176,1556012,4823176
07/05/2021,Tamil Nadu,6478830,99642,4866561,1612269,4866561
08/05/2021,Tamil Nadu,6546261,67431,4895451,1650810,4895451
09/05/2021,Tamil Nadu,6569914,23653,4906062,1663852,4906062
10/05/2021,Tamil Nadu,6676837,106923,4951333,1725504,4951333
11/05/2021,Tamil Nadu,6762623,85786,4991388,1771235,4991388
12/05/2021,Tamil Nadu,6851406,88783,5037596,1813810,5037596
13/05/2021,Tamil Nadu,6951309,99903,5092140,1859169,5092140
14/05/2021,Tamil Nadu,7009930,58621,5126070,1883860,5126070
15/05/2021,Tamil Nadu,7074066,64136,5162834,1911232,5162834
16/05/2021,Tamil Nadu,7088176,14110,5172965,1915211,5172965
17/05/2021,Tamil Nadu,7145700,57524,5216811,1928889,5216811
18/05/2021,Tamil Nadu,7194563,48863,5255610,1938953,5255610
19/05/2021,Tamil Nadu,7238986,44423,5292027,1946959,5292027
20/05/2021,Tamil Nadu,7281385,42399,5328713,1952672,5328713
21/05/2021,Tamil Nadu,7324570,43185,5366882,1957688,5366882
22/05/2021,Tamil Nadu,7376365,51795,5414503,1961862,5414503
23/05/2021,Tamil Nadu,7391550,15185,5428452,1963098,5428452
24/05/2021,Tamil Nadu,7474446,82896,5507417,1967029,5507417
25/05/2021,Tamil Nadu,7661541,187095,5690306,1971235,5690306
26/05/2021,Tamil Nadu,7911981,250440,5937633,1974348,5937633
27/05/2021,Tamil Nadu,8207573,295592,6228593,1978980,6228593
28/05/2021,Tamil Nadu,8515660,308087,6520208,1995452,6520208
29/05/2021,Tamil Nadu,8794771,279111,6781739,2013032,6781739
30/05/2021,Tamil Nadu,8893998,99227,6875084,2018914,6875084
31/05/2021,Tamil Nadu,9095854,201856,7063107,2032747,7063107
01/06/2021,Tamil Nadu,9240004,144150,7190142,2049862,7190142
02/06/2021,Tamil Nadu,9349171,109167,7286844,2062327,7286844
03/06/2021,Tamil Nadu,9620641,271470,7545710,2074931,7545710
04/06/2021,Tamil Nadu,9876220,255579,7790199,2086021,7790199
05/06/2021,Tamil Nadu,10018873,142653,7924700,2094173,7924700
06/06/2021,Tamil Nadu,10069493,50620,7972482,2097011,7972482
07/06/2021,Tamil Nadu,10135731,66238,8031685,2104046,8031685
08/06/2021,Tamil Nadu,10185541,49810,8076791,2108750,8076791
09/06/2021,Tamil Nadu,10228792,43251,8116108,2112684,8116108
10/06/2021,Tamil Nadu,10272414,43622,8156189,2116225,8156189
11/06/2021,Tamil Nadu,10340158,67744,8215741,2124417,8215741
12/06/2021,Tamil Nadu,10648430,308272,8503345,2145085,8503345
13/06/2021,Tamil Nadu,10866186,217756,8711904,2154282,8711904
14/06/2021,Tamil Nadu,11147886,281700,8976866,2171020,8976866
15/06/2021,Tamil Nadu,11285738,137852,9104491,2181247,9104491
16/06/2021,Tamil Nadu,11643851,358113,9441618,2202233,9441618
17/06/2021,Tamil Nadu,11935112,291261,9713059,2222053,9713059
18/06/2021,Tamil Nadu,12148674,213562,9911018,2237656,9911018
19/06/2021,Tamil Nadu,12498914,350240,10238404,2260510,10238404
20/06/2021,Tamil Nadu,12701415,202501,10429212,2272203,10429212
21/06/2021,Tamil Nadu,13106666,405251,10807056,2299610,10807056
22/06/2021,Tamil Nadu,13414792,308126,11092832,2321960,11092832
23/06/2021,Tamil Nadu,13636788,221996,11289696,2347092,11289696
24/06/2021,Tamil Nadu,14048419,411631,11658908,2389511,11658908
25/06/2021,Tamil Nadu,14478557,430138,12056330,2422227,
26/06/2021,Tamil Nadu,14890041,411484,12420061,2469980,
27/06/2021,Tamil Nadu,15021946,131905,12535263,2486683,
28/06/2021,Tamil Nadu,15231397,209451,12716906,2514491,
29/06/2021,Tamil Nadu,15510424,279027,12963745,2546679,
30/06/2021,Tamil Nadu,15642085,131661,13072807,2569278,
01/07/2021,Tamil Nadu,15859592,217507,13260693,2598899,
02/07/2021,Tamil Nadu,16171046,311454,13523115,2647931,
03/07/2021,Tamil Nadu,16636165,465119,13922204,2713961,
04/07/2021,Tamil Nadu,16747198,111033,14014851,2732347,
05/07/2021,Tamil Nadu,16920558,173360,14153278,2767280,
06/07/2021,Tamil Nadu,17017222,96664,14224524,2792698,
07/07/2021,Tamil Nadu,17093526,76304,14279592,2813934,
08/07/2021,Tamil Nadu,17242667,149141,14363188,2879479,
09/07/2021,Tamil Nadu,17335483,92816,14417332,2918151,
10/07/2021,Tamil Nadu,17404688,69205,14464514,2940174,
11/07/2021,Tamil Nadu,17489838,85150,14521299,2968539,
12/07/2021,Tamil Nadu,17843953,354115,14777773,3066180,
13/07/2021,Tamil Nadu,18181398,337445,15039119,3142279,
14/07/2021,Tamil Nadu,18548239,366841,15322521,3225718,
15/07/2021,Tamil Nadu,18730668,182429,15443587,3287081,
16/07/2021,Tamil Nadu,19028978,298310,15655125,3373853,
17/07/2021,Tamil Nadu,19382285,353307,15924709,3457576,
18/07/2021,Tamil Nadu,19496996,114711,16014013,3482983,
19/07/2021,Tamil Nadu,19749085,252089,16212301,3536784,
20/07/2021,Tamil Nadu,19919524,170439,16351116,3568408,
21/07/2021,Tamil Nadu,20093881,174357,16489572,3604309,
22/07/2021,Tamil Nadu,20398939,305058,16739547,3659392,
23/07/2021,Tamil Nadu,20724967,326028,17001787,3723180,
24/07/2021,Tamil Nadu,21027753,302786,17244484,3783269,
25/07/2021,Tamil Nadu,21134839,107086,17331126,3803713,
26/07/2021,Tamil Nadu,21430837,295998,17578231,3852606,
27/07/2021,Tamil Nadu,21727255,296418,17830930,3896325,
28/07/2021,Tamil Nadu,21985876,258621,18046934,3938942,
29/07/2021,Tamil Nadu,22323375,337499,18307571,4015804,
30/07/2021,Tamil Nadu,22660132,336757,18555545,4104587,
31/07/2021,Tamil Nadu,23036192,376060,18835602,4200590,
01/08/2021,Tamil Nadu,23303574,267382,19063195,4240379,
02/08/2021,Tamil Nadu,23622736,319162,19321702,4301034,
03/08/2021,Tamil Nadu,23903639,280903,19547901,4355738,
04/08/2021,Tamil Nadu,24199269,295630,19760942,4438327,
05/08/2021,Tamil Nadu,24495564,296295,19998737,4496827,
06/08/2021,Tamil Nadu,24818414,322850,20255133,4563281,
07/08/2021,Tamil Nadu,25126156,307742,20507625,4618531,
08/08/2021,Tamil Nadu,25277500,151344,20635755,4641745,
09/08/2021,Tamil Nadu,25522708,245208,20836674,4686034,
,,,,,,
,,,,,,
,,,,,,
,,,,,,
,,,,,,
,,,,,,
16/01/2021,Telangana,317,317,317,0,317
17/01/2021,Telangana,437,120,437,0,437
18/01/2021,Telangana,2463,2026,2463,0,2463
19/01/2021,Telangana,11169,8706,11169,0,11169
20/01/2021,Telangana,11291,122,11291,0,11291
21/01/2021,Telangana,17837,6546,17837,0,17837
22/01/2021,Telangana,24830,6993,24830,0,24830
23/01/2021,Telangana,26183,1353,26183,0,26183
24/01/2021,Telangana,27829,1646,27829,0,27829
25/01/2021,Telangana,50646,22817,50646,0,50646
26/01/2021,Telangana,51194,548,51194,0,51194
27/01/2021,Telangana,58306,7112,58306,0,58306
28/01/2021,Telangana,78713,20407,78713,0,78713
29/01/2021,Telangana,92418,13705,92418,0,92418
30/01/2021,Telangana,95000,2582,95000,0,95000
31/01/2021,Telangana,95057,57,95057,0,95057
01/02/2021,Telangana,95234,177,95234,0,95234
02/02/2021,Telangana,96413,1179,96413,0,96413
03/02/2021,Telangana,103183,6770,103183,0,103183
04/02/2021,Telangana,114647,11464,114647,0,114647
05/02/2021,Telangana,121588,6941,121588,0,121588
06/02/2021,Telangana,135977,14389,135977,0,135977
07/02/2021,Telangana,136225,248,136225,0,136225
08/02/2021,Telangana,156285,20060,156285,0,156285
09/02/2021,Telangana,171308,15023,171308,0,171308
10/02/2021,Telangana,186195,14887,186195,0,186195
11/02/2021,Telangana,198677,12482,198677,0,198677
12/02/2021,Telangana,206864,8187,206864,0,206864
13/02/2021,Telangana,211719,4855,209790,1929,209790
14/02/2021,Telangana,212538,819,210201,2337,210201
15/02/2021,Telangana,231322,18784,219843,11479,219843
16/02/2021,Telangana,290997,59675,250141,40856,250141
17/02/2021,Telangana,291913,916,250649,41264,250649
18/02/2021,Telangana,325420,33507,260486,64934,260486
19/02/2021,Telangana,355287,29867,276506,78781,276506
20/02/2021,Telangana,357179,1892,277517,79662,277517
21/02/2021,Telangana,357467,288,277539,79928,277539
22/02/2021,Telangana,376262,18795,278786,97476,278786
23/02/2021,Telangana,377711,1449,279390,98321,279390
24/02/2021,Telangana,379363,1652,281009,98354,281009
25/02/2021,Telangana,400394,21031,283924,116470,283924
26/02/2021,Telangana,419089,18695,291425,127664,291425
27/02/2021,Telangana,419089,0,291425,127664,291425
28/02/2021,Telangana,419089,0,291425,127664,291425
01/03/2021,Telangana,419089,0,291425,127664,291425
02/03/2021,Telangana,426555,7466,297234,129321,297234
03/03/2021,Telangana,438614,12059,306322,132292,306322
04/03/2021,Telangana,462808,24194,322444,140364,322444
05/03/2021,Telangana,488204,25396,341073,147131,341073
06/03/2021,Telangana,520798,32594,362082,158716,362082
07/03/2021,Telangana,522369,1571,363597,158772,363597
08/03/2021,Telangana,561227,38858,389985,171242,389985
09/03/2021,Telangana,424673,-136554,241595,183078,424673
10/03/2021,Telangana,447836,23163,256024,191812,447836
11/03/2021,Telangana,451366,3530,259321,192045,451366
12/03/2021,Telangana,480210,28844,275371,204839,480210
13/03/2021,Telangana,496264,16054,288451,207813,496264
14/03/2021,Telangana,498020,1756,290186,207834,498020
15/03/2021,Telangana,528117,30097,315832,212285,528117
16/03/2021,Telangana,722573,194456,507868,214705,507868
17/03/2021,Telangana,845902,123329,630011,215891,630011
18/03/2021,Telangana,878581,32679,661459,217122,661459
19/03/2021,Telangana,906927,28346,688667,218260,688667
20/03/2021,Telangana,939941,33014,720396,219545,720396
21/03/2021,Telangana,943919,3978,724262,219657,724262
22/03/2021,Telangana,979723,35804,758722,221001,758722
23/03/2021,Telangana,1016879,37156,793939,222940,793939
24/03/2021,Telangana,1051931,35052,828174,223757,828174
25/03/2021,Telangana,1093196,41265,867030,226166,867030
26/03/2021,Telangana,1134829,41633,905529,229300,905529
27/03/2021,Telangana,1171066,36237,940796,230270,940796
28/03/2021,Telangana,1173165,2099,942868,230297,942868
29/03/2021,Telangana,1186001,12836,955419,230582,955419
30/03/2021,Telangana,1231006,45005,997601,233405,997601
31/03/2021,Telangana,1267237,36231,1030664,236573,1030664
01/04/2021,Telangana,1317924,50687,1077830,240094,1077830
02/04/2021,Telangana,1384865,66941,1140121,244744,1140121
03/04/2021,Telangana,1434779,49914,1185843,248936,1185843
04/04/2021,Telangana,1478863,44084,1227030,251833,1227030
05/04/2021,Telangana,1534833,55970,1278480,256353,1278480
06/04/2021,Telangana,1573611,38778,1313584,260027,1313584
07/04/2021,Telangana,1676020,102409,1405944,270076,1405944
08/04/2021,Telangana,1783117,107097,1504570,278547,1504570
09/04/2021,Telangana,1898182,115065,1611380,286802,1611380
10/04/2021,Telangana,2059925,161743,1763427,296498,1763427
11/04/2021,Telangana,2161186,101261,1861282,299904,1861282
12/04/2021,Telangana,2292040,130854,1982573,309467,1982573
13/04/2021,Telangana,2318151,26111,2006982,311169,2006982
14/04/2021,Telangana,2452611,134460,2129490,323121,2129490
15/04/2021,Telangana,2621835,169224,2283343,338492,2283343
16/04/2021,Telangana,2802063,180228,2447626,354437,2447626
17/04/2021,Telangana,2952245,150182,2584964,367281,2584964
18/04/2021,Telangana,2960202,7957,2591096,369106,2591096
19/04/2021,Telangana,3132540,172338,2742005,390535,2742005
20/04/2021,Telangana,3272099,139559,2861258,410841,2861258
21/04/2021,Telangana,3394643,122544,2965467,429176,2965467
22/04/2021,Telangana,3604586,209943,3148315,456271,3148315
23/04/2021,Telangana,3811861,207275,3332501,479360,3332501
24/04/2021,Telangana,4003828,191967,3500047,503781,3500047
25/04/2021,Telangana,4071469,67641,3559142,512327,3559142
26/04/2021,Telangana,4286975,215506,3744656,542319,3744656
27/04/2021,Telangana,4400003,113028,3837190,562813,3837190
28/04/2021,Telangana,4542064,142061,3955399,586665,3955399
29/04/2021,Telangana,4612780,70716,4010610,602170,4010610
30/04/2021,Telangana,4780184,167404,4151762,628422,4151762
01/05/2021,Telangana,4787544,7360,4157933,629611,4157933
02/05/2021,Telangana,4787811,267,4158090,629721,4158090
03/05/2021,Telangana,4815920,28109,4178677,637243,4178677
04/05/2021,Telangana,4881513,65593,4227755,653758,4227755
05/05/2021,Telangana,4960587,79074,4275187,685400,4275187
06/05/2021,Telangana,5042065,81478,4325903,716162,4325903
07/05/2021,Telangana,5122572,80507,4376415,746157,4376415
08/05/2021,Telangana,5202960,80388,4388638,814322,4388638
09/05/2021,Telangana,5205226,2266,4389592,815634,4389592
10/05/2021,Telangana,5313900,108674,4406542,907358,4406542
11/05/2021,Telangana,5406513,92613,4422419,984094,4422419
12/05/2021,Telangana,5440783,34270,4432324,1008459,4432324
13/05/2021,Telangana,5479812,39029,4442464,1037348,4442464
14/05/2021,Telangana,5513553,33741,4450029,1063524,4450029
15/05/2021,Telangana,5513738,185,4450028,1063710,4450028
16/05/2021,Telangana,5513723,-15,4450013,1063710,4450013
17/05/2021,Telangana,5514512,789,4450594,1063918,4450594
18/05/2021,Telangana,5516590,2078,4451311,1065279,4451311
19/05/2021,Telangana,5519773,3183,4451824,1067949,4451824
20/05/2021,Telangana,5523167,3394,4452572,1070595,4452572
21/05/2021,Telangana,5523980,813,4453033,1070947,4453033
22/05/2021,Telangana,5526806,2826,4453425,1073381,4453425
23/05/2021,Telangana,5527533,727,4453837,1073696,4453837
24/05/2021,Telangana,5530377,2844,4454485,1075892,4454485
25/05/2021,Telangana,5589800,59423,4462811,1126989,4462811
26/05/2021,Telangana,5653872,64072,4477983,1175889,4477983
27/05/2021,Telangana,5704158,50286,4495506,1208652,4495506
28/05/2021,Telangana,5807342,103184,4577957,1229385,4577957
29/05/2021,Telangana,5918092,110750,4672773,1245319,4672773
30/05/2021,Telangana,5985460,67368,4737360,1248100,4737360
31/05/2021,Telangana,6064809,79349,4802730,1262079,4802730
01/06/2021,Telangana,6151360,86551,4878994,1272366,4878994
02/06/2021,Telangana,6226923,75563,4947737,1279186,4947737
03/06/2021,Telangana,6320774,93851,5033655,1287119,5033655
04/06/2021,Telangana,6428387,107613,5133125,1295262,5133125
05/06/2021,Telangana,6577056,148669,5274798,1302258,5274798
06/06/2021,Telangana,6695588,118532,5391957,1303631,5391957
07/06/2021,Telangana,6865466,169878,5554284,1311182,5554284
08/06/2021,Telangana,7046084,180618,5728537,1317547,5728537
09/06/2021,Telangana,7224148,178064,5900344,1323804,5900344
10/06/2021,Telangana,7404779,180631,6074863,1329916,6074863
11/06/2021,Telangana,7616140,211361,6279779,1336361,6279779
12/06/2021,Telangana,7830864,214724,6488020,1342844,6488020
13/06/2021,Telangana,7981120,150256,6636883,1344237,6636883
14/06/2021,Telangana,8167470,186350,6817886,1349584,6817886
15/06/2021,Telangana,8333524,166054,6979076,1354448,6979076
16/06/2021,Telangana,8511947,178423,7151956,1359991,7151956
17/06/2021,Telangana,8694842,182895,7327371,1367471,7327371
18/06/2021,Telangana,8874911,180069,7499623,1375288,7499623
19/06/2021,Telangana,9069710,194799,7684311,1385399,7684311
20/06/2021,Telangana,9173921,104211,7785158,1388763,7785158
21/06/2021,Telangana,9327568,153647,7928931,1398637,7928931
22/06/2021,Telangana,9486520,158952,8076582,1409938,8076582
23/06/2021,Telangana,9654533,168013,8233390,1421143,8233390
24/06/2021,Telangana,9865603,211070,8430040,1435563,8430040
25/06/2021,Telangana,10082372,216769,8632930,1449442,
26/06/2021,Telangana,10326965,244593,8850210,1476755,
27/06/2021,Telangana,10431095,104130,8945567,1485528,
28/06/2021,Telangana,10654325,223230,9139505,1514820,
29/06/2021,Telangana,10874672,220347,9329183,1545489,
30/06/2021,Telangana,11071415,196743,9493724,1577691,
01/07/2021,Telangana,11240416,169001,9636141,1604275,
02/07/2021,Telangana,11423209,182793,9783478,1639731,
03/07/2021,Telangana,11631502,208293,9939364,1692138,
04/07/2021,Telangana,11648353,16851,9945428,1702925,
05/07/2021,Telangana,11830169,181816,10077461,1752708,
06/07/2021,Telangana,11966330,136161,10173744,1792586,
07/07/2021,Telangana,11992695,26365,10182849,1809846,
08/07/2021,Telangana,12106184,113489,10249542,1856642,
09/07/2021,Telangana,12272850,166666,10353167,1919683,
10/07/2021,Telangana,12395170,122320,10417596,1977574,
11/07/2021,Telangana,12409905,14735,10422316,1987589,
12/07/2021,Telangana,12589998,180093,10533342,2056656,
13/07/2021,Telangana,12746415,156417,10626050,2120365,
14/07/2021,Telangana,12840921,94506,10707196,2133725,
15/07/2021,Telangana,12962575,121654,10762037,2200538,
16/07/2021,Telangana,13148507,185932,10833368,2315139,
17/07/2021,Telangana,13267645,119138,10868291,2399354,
18/07/2021,Telangana,13280389,12744,10872534,2407855,
19/07/2021,Telangana,13453988,173599,10941162,2512826,
20/07/2021,Telangana,13502037,48049,10956059,2545978,
21/07/2021,Telangana,13517322,15285,10961026,2556296,
22/07/2021,Telangana,13699633,182311,11025806,2673827,
23/07/2021,Telangana,13843213,143580,11038921,2804292,
24/07/2021,Telangana,14010811,167598,11070089,2940722,
25/07/2021,Telangana,14020071,9260,11074061,2946010,
26/07/2021,Telangana,14167136,147065,11107971,3059165,
27/07/2021,Telangana,14274446,107310,11133570,3140876,
28/07/2021,Telangana,14291866,17420,11140017,3151849,
29/07/2021,Telangana,14456726,164860,11176326,3280400,
30/07/2021,Telangana,14585763,129037,11205561,3380202,
31/07/2021,Telangana,14733008,147245,11249396,3483612,
01/08/2021,Telangana,14841727,108719,11349272,3492455,
02/08/2021,Telangana,14960104,118377,11391372,3568732,
03/08/2021,Telangana,15079216,119112,11437002,3642214,
04/08/2021,Telangana,15095872,16656,11446097,3649775,
05/08/2021,Telangana,15237716,141844,11485426,3752290,
06/08/2021,Telangana,15376994,139278,11548283,3828711,
07/08/2021,Telangana,15483265,106271,11589487,3893778,
08/08/2021,Telangana,15494344,11079,11597334,3897010,
09/08/2021,Telangana,15614892,120548,11649268,3965624,
,,,,,,
,,,,,,
,,,,,,
,,,,,,
,,,,,,
,,,,,,
16/01/2021,Tripura,107,107,107,0,107
17/01/2021,Tripura,107,0,107,0,107
18/01/2021,Tripura,230,123,230,0,230
19/01/2021,Tripura,681,451,681,0,681
20/01/2021,Tripura,687,6,687,0,687
21/01/2021,Tripura,1812,1125,1812,0,1812
22/01/2021,Tripura,3321,1509,3321,0,3321
23/01/2021,Tripura,3349,28,3349,0,3349
24/01/2021,Tripura,3774,425,3774,0,3774
25/01/2021,Tripura,9693,5919,9693,0,9693
26/01/2021,Tripura,9946,253,9946,0,9946
27/01/2021,Tripura,12366,2420,12366,0,12366
28/01/2021,Tripura,16668,4302,16668,0,16668
29/01/2021,Tripura,19513,2845,19513,0,19513
30/01/2021,Tripura,21342,1829,21342,0,21342
31/01/2021,Tripura,21367,25,21367,0,21367
01/02/2021,Tripura,22996,1629,22996,0,22996
02/02/2021,Tripura,24202,1206,24202,0,24202
03/02/2021,Tripura,24413,211,24413,0,24413
04/02/2021,Tripura,27081,2668,27081,0,27081
05/02/2021,Tripura,29402,2321,29402,0,29402
06/02/2021,Tripura,32235,2833,32235,0,32235
07/02/2021,Tripura,32289,54,32289,0,32289
08/02/2021,Tripura,37310,5021,37310,0,37310
09/02/2021,Tripura,42999,5689,42999,0,42999
10/02/2021,Tripura,45158,2159,45158,0,45158
11/02/2021,Tripura,51453,6295,51453,0,51453
12/02/2021,Tripura,57389,5936,57389,0,57389
13/02/2021,Tripura,61844,4455,61510,334,61510
14/02/2021,Tripura,61859,15,61525,334,61525
15/02/2021,Tripura,68497,6638,66987,1510,66987
16/02/2021,Tripura,68681,184,67171,1510,67171
17/02/2021,Tripura,72074,3393,69698,2376,69698
18/02/2021,Tripura,79660,7586,72899,6761,72899
19/02/2021,Tripura,90564,10904,79570,10994,79570
20/02/2021,Tripura,92289,1725,80875,11414,80875
21/02/2021,Tripura,92291,2,80877,11414,80877
22/02/2021,Tripura,97257,4966,82561,14696,82561
23/02/2021,Tripura,100084,2827,84098,15986,84098
24/02/2021,Tripura,100676,592,84636,16040,84636
25/02/2021,Tripura,105468,4792,86553,18915,86553
26/02/2021,Tripura,109091,3623,88089,21002,88089
27/02/2021,Tripura,109091,0,88089,21002,88089
28/02/2021,Tripura,109091,0,88089,21002,88089
01/03/2021,Tripura,109091,0,88089,21002,88089
02/03/2021,Tripura,116435,7344,92853,23582,92853
03/03/2021,Tripura,119114,2679,94340,24774,94340
04/03/2021,Tripura,125744,6630,99422,26322,99422
05/03/2021,Tripura,132807,7063,104553,28254,104553
06/03/2021,Tripura,135652,2845,106718,28934,106718
07/03/2021,Tripura,135657,5,106720,28937,106720
08/03/2021,Tripura,146407,10750,113725,32682,113725
09/03/2021,Tripura,124161,-22246,87282,36879,124161
10/03/2021,Tripura,125961,1800,88029,37932,125961
11/03/2021,Tripura,127690,1729,88696,38994,127690
12/03/2021,Tripura,139399,11709,94396,45003,139399
13/03/2021,Tripura,143379,3980,96147,47232,143379
14/03/2021,Tripura,143677,298,96435,47242,143677
15/03/2021,Tripura,162711,19034,108793,53918,162711
16/03/2021,Tripura,219327,56616,162040,57287,162040
17/03/2021,Tripura,228934,9607,170793,58141,170793
18/03/2021,Tripura,256216,27282,194882,61334,194882
19/03/2021,Tripura,287711,31495,223573,64138,223573
20/03/2021,Tripura,313388,25677,247875,65513,247875
21/03/2021,Tripura,323586,10198,257944,65642,257944
22/03/2021,Tripura,355556,31970,287869,67687,287869
23/03/2021,Tripura,407572,52016,337930,69642,337930
24/03/2021,Tripura,467382,59810,396634,70748,396634
25/03/2021,Tripura,531721,64339,459726,71995,459726
26/03/2021,Tripura,599228,67507,526236,72992,526236
27/03/2021,Tripura,624648,25420,551306,73342,551306
28/03/2021,Tripura,632439,7791,559037,73402,559037
29/03/2021,Tripura,633966,1527,560561,73405,560561
30/03/2021,Tripura,660734,26768,585980,74754,585980
31/03/2021,Tripura,673612,12878,597956,75656,597956
01/04/2021,Tripura,689959,16347,613140,76819,613140
02/04/2021,Tripura,702866,12907,625172,77694,625172
03/04/2021,Tripura,714805,11939,635930,78875,635930
04/04/2021,Tripura,725171,10366,645348,79823,645348
05/04/2021,Tripura,739873,14702,657921,81952,657921
06/04/2021,Tripura,751713,11840,668678,83035,668678
07/04/2021,Tripura,764951,13238,680375,84576,680375
08/04/2021,Tripura,785418,20467,698009,87409,698009
09/04/2021,Tripura,802740,17322,712932,89808,712932
10/04/2021,Tripura,812195,9455,720930,91265,720930
11/04/2021,Tripura,819047,6852,727172,91875,727172
12/04/2021,Tripura,832810,13763,737653,95157,737653
13/04/2021,Tripura,842326,9516,744903,97423,744903
14/04/2021,Tripura,845145,2819,746994,98151,746994
15/04/2021,Tripura,845297,152,747073,98224,747073
16/04/2021,Tripura,862461,17164,756408,106053,756408
17/04/2021,Tripura,880184,17723,766208,113976,766208
18/04/2021,Tripura,886066,5882,769465,116601,769465
19/04/2021,Tripura,910220,24154,780166,130054,780166
20/04/2021,Tripura,933793,23573,790891,142902,790891
21/04/2021,Tripura,941554,7761,794856,146698,794856
22/04/2021,Tripura,953497,11943,799703,153794,799703
23/04/2021,Tripura,984781,31284,811199,173582,811199
24/04/2021,Tripura,1011821,27040,820575,191246,820575
25/04/2021,Tripura,1020894,9073,824638,196256,824638
26/04/2021,Tripura,1066507,45613,840232,226275,840232
27/04/2021,Tripura,1113260,46753,856586,256674,856586
28/04/2021,Tripura,1139662,26402,866008,273654,866008
29/04/2021,Tripura,1189803,50141,882252,307551,882252
30/04/2021,Tripura,1236761,46958,898611,338150,898611
01/05/2021,Tripura,1261570,24809,907499,354071,907499
02/05/2021,Tripura,1267044,5474,909670,357374,909670
03/05/2021,Tripura,1284939,17895,915489,369450,915489
04/05/2021,Tripura,1307268,22329,921704,385564,921704
05/05/2021,Tripura,1328697,21429,927468,401229,927468
06/05/2021,Tripura,1362400,33703,936213,426187,936213
07/05/2021,Tripura,1396362,33962,946489,449873,946489
08/05/2021,Tripura,1418622,22260,952947,465675,952947
09/05/2021,Tripura,1421511,2889,953744,467767,953744
10/05/2021,Tripura,1446246,24735,960991,485255,960991
11/05/2021,Tripura,1465368,19122,966997,498371,966997
12/05/2021,Tripura,1469744,4376,968790,500954,968790
13/05/2021,Tripura,1479866,10122,974828,505038,974828
14/05/2021,Tripura,1486004,6138,980319,505685,980319
15/05/2021,Tripura,1492191,6187,985530,506661,985530
16/05/2021,Tripura,1492618,427,985851,506767,985851
17/05/2021,Tripura,1501848,9230,995017,506831,995017
18/05/2021,Tripura,1512008,10160,1005122,506886,1005122
19/05/2021,Tripura,1520712,8704,1013813,506899,1013813
20/05/2021,Tripura,1527785,7073,1020857,506928,1020857
21/05/2021,Tripura,1535201,7416,1028248,506953,1028248
22/05/2021,Tripura,1551547,16346,1044552,506995,1044552
23/05/2021,Tripura,1554305,2758,1047296,507009,1047296
24/05/2021,Tripura,1560657,6352,1053532,507125,1053532
25/05/2021,Tripura,1566075,5418,1058833,507242,1058833
26/05/2021,Tripura,1568298,2223,1060986,507312,1060986
27/05/2021,Tripura,1571247,2949,1063835,507412,1063835
28/05/2021,Tripura,1574603,3356,1067114,507489,1067114
29/05/2021,Tripura,1588209,13606,1080636,507573,1080636
30/05/2021,Tripura,1602077,13868,1094499,507578,1094499
31/05/2021,Tripura,1610784,8707,1103113,507671,1103113
01/06/2021,Tripura,1615053,4269,1107337,507716,1107337
02/06/2021,Tripura,1618490,3437,1110714,507776,1110714
03/06/2021,Tripura,1624620,6130,1116768,507852,1116768
04/06/2021,Tripura,1631384,6764,1123405,507979,1123405
05/06/2021,Tripura,1635643,4259,1127599,508044,1127599
06/06/2021,Tripura,1636673,1030,1128612,508061,1128612
07/06/2021,Tripura,1640638,3965,1132397,508241,1132397
08/06/2021,Tripura,1644382,3744,1135952,508430,1135952
09/06/2021,Tripura,1646329,1947,1137795,508534,1137795
10/06/2021,Tripura,1649999,3670,1141134,508865,1141134
11/06/2021,Tripura,1652388,2389,1143222,509166,1143222
12/06/2021,Tripura,1659919,7531,1147382,512537,1147382
13/06/2021,Tripura,1661096,1177,1148442,512654,1148442
14/06/2021,Tripura,1681689,20593,1164688,517001,1164688
15/06/2021,Tripura,1706142,24453,1185855,520287,1185855
16/06/2021,Tripura,1736324,30182,1213866,522458,1213866
17/06/2021,Tripura,1791260,54936,1264502,526758,1264502
18/06/2021,Tripura,1860877,69617,1328982,531895,1328982
19/06/2021,Tripura,1920866,59989,1383797,537069,1383797
20/06/2021,Tripura,1942706,21840,1403613,539093,1403613
21/06/2021,Tripura,2093251,150545,1549142,544109,1549142
22/06/2021,Tripura,2285345,192094,1733843,551502,1733843
23/06/2021,Tripura,2344975,59630,1788351,556624,1788351
24/06/2021,Tripura,2396775,51800,1834177,562598,1834177
25/06/2021,Tripura,2428555,31780,1861984,566571,
26/06/2021,Tripura,2467674,39119,1894007,573667,
27/06/2021,Tripura,2474475,6801,1899573,574902,
28/06/2021,Tripura,2510943,36468,1926146,584797,
29/06/2021,Tripura,2536995,26052,1946066,590929,
30/06/2021,Tripura,2550343,13348,1955929,594414,
01/07/2021,Tripura,2568901,18558,1969442,599459,
02/07/2021,Tripura,2595949,27048,1987663,608286,
03/07/2021,Tripura,2613487,17538,1998901,614586,
04/07/2021,Tripura,2615391,1904,2000280,615111,
05/07/2021,Tripura,2630048,14657,2009213,620835,
06/07/2021,Tripura,2642602,12554,2017943,624659,
07/07/2021,Tripura,2648571,5969,2022188,626383,
08/07/2021,Tripura,2662612,14041,2031459,631153,
09/07/2021,Tripura,2681121,18509,2043269,637852,
10/07/2021,Tripura,2705451,24330,2058009,647442,
11/07/2021,Tripura,2708867,3416,2060295,648572,
12/07/2021,Tripura,2733684,24817,2074654,659030,
13/07/2021,Tripura,2755529,21845,2088117,667412,
14/07/2021,Tripura,2782404,26875,2109378,673026,
15/07/2021,Tripura,2808453,26049,2126035,682418,
16/07/2021,Tripura,2827700,19247,2137737,689963,
17/07/2021,Tripura,2832538,4838,2140335,692203,
18/07/2021,Tripura,2833900,1362,2141163,692737,
19/07/2021,Tripura,2855785,21885,2153655,702130,
20/07/2021,Tripura,2874151,18366,2163480,710671,
21/07/2021,Tripura,2878597,4446,2165745,712852,
22/07/2021,Tripura,2899319,20722,2177099,722220,
23/07/2021,Tripura,2921426,22107,2190299,731127,
24/07/2021,Tripura,2951600,30174,2209808,741792,
25/07/2021,Tripura,2972645,21045,2226413,746232,
26/07/2021,Tripura,2999864,27219,2245548,754316,
27/07/2021,Tripura,3035040,35176,2272429,762611,
28/07/2021,Tripura,3076716,41676,2305601,771115,
29/07/2021,Tripura,3102351,25635,2325845,776506,
30/07/2021,Tripura,3124359,22008,2343012,781347,
31/07/2021,Tripura,3145201,20842,2360019,785182,
01/08/2021,Tripura,3164140,18939,2378296,785844,
02/08/2021,Tripura,3172471,8331,2383624,788847,
03/08/2021,Tripura,3180752,8281,2389080,791672,
04/08/2021,Tripura,3186637,5885,2393062,793575,
05/08/2021,Tripura,3192345,5708,2396498,795847,
06/08/2021,Tripura,3200135,7790,2402094,798041,
07/08/2021,Tripura,3205399,5264,2405290,800109,
08/08/2021,Tripura,3206922,1523,2406606,800316,
09/08/2021,Tripura,3215294,8372,2411195,804099,
,,,,,,
,,,,,,
,,,,,,
,,,,,,
,,,,,,
,,,,,,
16/01/2021,Uttar Pradesh,2212,2212,2212,0,2212
17/01/2021,Uttar Pradesh,2224,12,2224,0,2224
18/01/2021,Uttar Pradesh,1532,-692,1532,0,1532
19/01/2021,Uttar Pradesh,1568,36,1568,0,1568
20/01/2021,Uttar Pradesh,1568,0,1568,0,1568
21/01/2021,Uttar Pradesh,1578,10,1578,0,1578
22/01/2021,Uttar Pradesh,21325,19747,21325,0,21325
23/01/2021,Uttar Pradesh,30644,9319,30644,0,30644
24/01/2021,Uttar Pradesh,43669,13025,43669,0,43669
25/01/2021,Uttar Pradesh,59780,16111,59780,0,59780
26/01/2021,Uttar Pradesh,62477,2697,62477,0,62477
27/01/2021,Uttar Pradesh,95724,33247,95724,0,95724
28/01/2021,Uttar Pradesh,268081,172357,268081,0,268081
29/01/2021,Uttar Pradesh,429946,161865,429946,0,429946
30/01/2021,Uttar Pradesh,433040,3094,433040,0,433040
31/01/2021,Uttar Pradesh,434185,1145,434185,0,434185
01/02/2021,Uttar Pradesh,434549,364,434549,0,434549
02/02/2021,Uttar Pradesh,435502,953,435502,0,435502
03/02/2021,Uttar Pradesh,435645,143,435645,0,435645
04/02/2021,Uttar Pradesh,555622,119977,555622,0,555622
05/02/2021,Uttar Pradesh,636917,81295,636917,0,636917
06/02/2021,Uttar Pradesh,638107,1190,638107,0,638107
07/02/2021,Uttar Pradesh,638805,698,638805,0,638805
08/02/2021,Uttar Pradesh,640144,1339,640144,0,640144
09/02/2021,Uttar Pradesh,640845,701,640845,0,640845
10/02/2021,Uttar Pradesh,643010,2165,643010,0,643010
11/02/2021,Uttar Pradesh,746208,103198,746208,0,746208
12/02/2021,Uttar Pradesh,863157,116949,863157,0,863157
13/02/2021,Uttar Pradesh,864381,1224,864379,2,864379
14/02/2021,Uttar Pradesh,864489,108,864487,2,864487
15/02/2021,Uttar Pradesh,975211,110722,955423,19788,955423
16/02/2021,Uttar Pradesh,975907,696,956093,19814,956093
17/02/2021,Uttar Pradesh,976088,181,956274,19814,956274
18/02/2021,Uttar Pradesh,1054867,78779,1034940,19927,1034940
19/02/2021,Uttar Pradesh,1234270,179403,1135502,98768,1135502
20/02/2021,Uttar Pradesh,1236861,2591,1136590,100271,1136590
21/02/2021,Uttar Pradesh,1237359,498,1136650,100709,1136650
22/02/2021,Uttar Pradesh,1339406,102047,1237517,101889,1237517
23/02/2021,Uttar Pradesh,1342030,2624,1239758,102272,1239758
24/02/2021,Uttar Pradesh,1342318,288,1240045,102273,1240045
25/02/2021,Uttar Pradesh,1521544,179226,1274807,246737,1274807
26/02/2021,Uttar Pradesh,1668629,147085,1281076,387553,1281076
27/02/2021,Uttar Pradesh,1668629,0,1281076,387553,1281076
28/02/2021,Uttar Pradesh,1668631,2,1281078,387553,1281078
01/03/2021,Uttar Pradesh,1668631,0,1281078,387553,1281078
02/03/2021,Uttar Pradesh,1681659,13028,1294029,387630,1294029
03/03/2021,Uttar Pradesh,1682667,1008,1295029,387638,1295029
04/03/2021,Uttar Pradesh,1824296,141629,1365655,458641,1365655
05/03/2021,Uttar Pradesh,1988090,163794,1465524,522566,1465524
06/03/2021,Uttar Pradesh,2014991,26901,1485787,529204,1485787
07/03/2021,Uttar Pradesh,2019181,4190,1488836,530345,1488836
08/03/2021,Uttar Pradesh,2216711,197530,1679720,536991,1679720
09/03/2021,Uttar Pradesh,1709561,-507150,1171217,538344,1709561
10/03/2021,Uttar Pradesh,1735799,26238,1196503,539296,1735799
11/03/2021,Uttar Pradesh,1741357,5558,1201688,539669,1741357
12/03/2021,Uttar Pradesh,2038409,297052,1426304,612105,2038409
13/03/2021,Uttar Pradesh,2079271,40862,1458839,620432,2079271
14/03/2021,Uttar Pradesh,2095485,16214,1474743,620742,2095485
15/03/2021,Uttar Pradesh,2398452,302967,1731354,667098,2398452
16/03/2021,Uttar Pradesh,3188522,790070,2456849,731673,2456849
17/03/2021,Uttar Pradesh,3464388,275866,2723448,740940,2723448
18/03/2021,Uttar Pradesh,3881080,416692,3034854,846226,3034854
19/03/2021,Uttar Pradesh,4231527,350447,3348666,882861,3348666
20/03/2021,Uttar Pradesh,4390444,158917,3497298,893146,3497298
21/03/2021,Uttar Pradesh,4416844,26400,3522238,894606,3522238
22/03/2021,Uttar Pradesh,4749723,332879,3797621,952102,3797621
23/03/2021,Uttar Pradesh,4960199,210476,3982323,977876,3982323
24/03/2021,Uttar Pradesh,5070493,110294,4087684,982809,4087684
25/03/2021,Uttar Pradesh,5344537,274044,4337751,1006786,4337751
26/03/2021,Uttar Pradesh,5563645,219108,4549205,1014440,4549205
27/03/2021,Uttar Pradesh,5644759,81114,4627476,1017283,4627476
28/03/2021,Uttar Pradesh,5648595,3836,4631003,1017592,4631003
29/03/2021,Uttar Pradesh,5648658,63,4631064,1017594,4631064
30/03/2021,Uttar Pradesh,5677982,29324,4659569,1018413,4659569
31/03/2021,Uttar Pradesh,5747886,69904,4726820,1021066,4726820
01/04/2021,Uttar Pradesh,5963390,215504,4929565,1033825,4929565
02/04/2021,Uttar Pradesh,6335715,372325,5281547,1054168,5281547
03/04/2021,Uttar Pradesh,6577701,241986,5511428,1066273,5511428
04/04/2021,Uttar Pradesh,6737463,159762,5663490,1073973,5663490
05/04/2021,Uttar Pradesh,7024060,286597,5917539,1106521,5917539
06/04/2021,Uttar Pradesh,7340259,316199,6199023,1141236,6199023
07/04/2021,Uttar Pradesh,7791657,451398,6619721,1171936,6619721
08/04/2021,Uttar Pradesh,8143966,352309,6950868,1193098,6950868
09/04/2021,Uttar Pradesh,8396201,252235,7169348,1226853,7169348
10/04/2021,Uttar Pradesh,8493841,97640,7255753,1238088,7255753
11/04/2021,Uttar Pradesh,8824093,330252,7558409,1265684,7558409
12/04/2021,Uttar Pradesh,9356612,532519,8013755,1342857,8013755
13/04/2021,Uttar Pradesh,9718148,361536,8329706,1388442,8329706
14/04/2021,Uttar Pradesh,10027627,309479,8605823,1421804,8605823
15/04/2021,Uttar Pradesh,10272414,244787,8790085,1482329,8790085
16/04/2021,Uttar Pradesh,10538062,265648,8978071,1559991,8978071
17/04/2021,Uttar Pradesh,10712197,174135,9102301,1609896,9102301
18/04/2021,Uttar Pradesh,10718349,6152,9106335,1612014,9106335
19/04/2021,Uttar Pradesh,10909053,190704,9224739,1684314,9224739
20/04/2021,Uttar Pradesh,11120514,211461,9356225,1764289,9356225
21/04/2021,Uttar Pradesh,11259040,138526,9449601,1809439,9449601
22/04/2021,Uttar Pradesh,11440742,181702,9563554,1877188,9563554
23/04/2021,Uttar Pradesh,11623304,182562,9679629,1943675,9679629
24/04/2021,Uttar Pradesh,11776922,153618,9779700,1997222,9779700
25/04/2021,Uttar Pradesh,11783929,7007,9783480,2000449,9783480
26/04/2021,Uttar Pradesh,11947377,163448,9883742,2063635,9883742
27/04/2021,Uttar Pradesh,12061238,113861,9953817,2107421,9953817
28/04/2021,Uttar Pradesh,12169041,107803,10018842,2150199,10018842
29/04/2021,Uttar Pradesh,12353995,184954,10125866,2228129,10125866
30/04/2021,Uttar Pradesh,12557806,203811,10240750,2317056,10240750
01/05/2021,Uttar Pradesh,12700692,142886,10331285,2369407,10331285
02/05/2021,Uttar Pradesh,12705437,4745,10334346,2371091,10334346
03/05/2021,Uttar Pradesh,12884995,179558,10439785,2445210,10439785
04/05/2021,Uttar Pradesh,13062635,177640,10544891,2517744,10544891
05/05/2021,Uttar Pradesh,13228006,165371,10642247,2585759,10642247
06/05/2021,Uttar Pradesh,13402535,174529,10742503,2660032,10742503
07/05/2021,Uttar Pradesh,13559957,157422,10833025,2726932,10833025
08/05/2021,Uttar Pradesh,13694748,134791,10914754,2779994,10914754
09/05/2021,Uttar Pradesh,13697577,2829,10916895,2780682,10916895
10/05/2021,Uttar Pradesh,13881053,183476,11025900,2855153,11025900
11/05/2021,Uttar Pradesh,14073046,191993,11141255,2931791,11141255
12/05/2021,Uttar Pradesh,14300912,227866,11291626,3009286,11291626
13/05/2021,Uttar Pradesh,14581474,280562,11465614,3115860,11465614
14/05/2021,Uttar Pradesh,14771189,189715,11590929,3180260,11590929
15/05/2021,Uttar Pradesh,14983606,212417,11723371,3260235,11723371
16/05/2021,Uttar Pradesh,14984918,1312,11724458,3260460,11724458
17/05/2021,Uttar Pradesh,15222236,237318,11943385,3278851,11943385
18/05/2021,Uttar Pradesh,15436461,214225,12144409,3292052,12144409
19/05/2021,Uttar Pradesh,15621166,184705,12319537,3301629,12319537
20/05/2021,Uttar Pradesh,15815757,194591,12501172,3314585,12501172
21/05/2021,Uttar Pradesh,16034048,218291,12704166,3329882,12704166
22/05/2021,Uttar Pradesh,16250118,216070,12905372,3344746,12905372
23/05/2021,Uttar Pradesh,16257569,7451,12912199,3345370,12912199
24/05/2021,Uttar Pradesh,16545766,288197,13182141,3363625,13182141
25/05/2021,Uttar Pradesh,16819746,273980,13439732,3380014,13439732
26/05/2021,Uttar Pradesh,17077311,257565,13683971,3393340,13683971
27/05/2021,Uttar Pradesh,17358612,281301,13951426,3407186,13951426
28/05/2021,Uttar Pradesh,17668206,309594,14243858,3424348,14243858
29/05/2021,Uttar Pradesh,17994300,326094,14544503,3449797,14544503
30/05/2021,Uttar Pradesh,18010911,16611,14560582,3450329,14560582
31/05/2021,Uttar Pradesh,18335009,324098,14854570,3480439,14854570
01/06/2021,Uttar Pradesh,18685319,350310,15179836,3505483,15179836
02/06/2021,Uttar Pradesh,19045624,360305,15512608,3533016,15512608
03/06/2021,Uttar Pradesh,19436908,391284,15875135,3561773,15875135
04/06/2021,Uttar Pradesh,19850174,413266,16254617,3595557,16254617
05/06/2021,Uttar Pradesh,20252136,401962,16624925,3627211,16624925
06/06/2021,Uttar Pradesh,20272802,20666,16643702,3629100,16643702
07/06/2021,Uttar Pradesh,20735794,462992,17079924,3655870,17079924
08/06/2021,Uttar Pradesh,21181060,445266,17502314,3678746,17502314
09/06/2021,Uttar Pradesh,21584490,403430,17883157,3701333,17883157
10/06/2021,Uttar Pradesh,22025903,441413,18297125,3728778,18297125
11/06/2021,Uttar Pradesh,22504047,478144,18741039,3763008,18741039
12/06/2021,Uttar Pradesh,22979323,475276,19184501,3794822,19184501
13/06/2021,Uttar Pradesh,23001682,22359,19205507,3796175,19205507
14/06/2021,Uttar Pradesh,23445493,443811,19608395,3837098,19608395
15/06/2021,Uttar Pradesh,23871523,426030,19995723,3875800,19995723
16/06/2021,Uttar Pradesh,24254164,382641,20343637,3910527,20343637
17/06/2021,Uttar Pradesh,24673597,419433,20725526,3948071,20725526
18/06/2021,Uttar Pradesh,25149677,476080,21162728,3986949,21162728
19/06/2021,Uttar Pradesh,25610808,461131,21587631,4023177,21587631
20/06/2021,Uttar Pradesh,25627085,16277,21602698,4024387,21602698
21/06/2021,Uttar Pradesh,26359410,732325,22296504,4062906,22296504
22/06/2021,Uttar Pradesh,27232439,873029,23129586,4102853,23129586
23/06/2021,Uttar Pradesh,28060510,828071,23918186,4142324,23918186
24/06/2021,Uttar Pradesh,28976470,915960,24782239,4194231,24782239
25/06/2021,Uttar Pradesh,29857504,881034,25598956,4258548,
26/06/2021,Uttar Pradesh,30451330,593826,26129782,4321548,
27/06/2021,Uttar Pradesh,30479424,28094,26154179,4325245,
28/06/2021,Uttar Pradesh,31002019,522595,26591964,4410055,
29/06/2021,Uttar Pradesh,31209641,207622,26740850,4468791,
30/06/2021,Uttar Pradesh,31281400,71759,26792784,4488616,
01/07/2021,Uttar Pradesh,31633572,352172,27047411,4586161,
02/07/2021,Uttar Pradesh,32067268,433696,27363633,4703635,
03/07/2021,Uttar Pradesh,32596520,529252,27776672,4819848,
04/07/2021,Uttar Pradesh,32629055,32535,27802518,4826537,
05/07/2021,Uttar Pradesh,33483868,854813,28472822,5011046,
06/07/2021,Uttar Pradesh,34513734,1029866,29305008,5208726,
07/07/2021,Uttar Pradesh,35267463,753729,29892445,5375018,
08/07/2021,Uttar Pradesh,36067913,800450,30535594,5532319,
09/07/2021,Uttar Pradesh,36814185,746272,31124499,5689686,
10/07/2021,Uttar Pradesh,37165499,351314,31368297,5797202,
11/07/2021,Uttar Pradesh,37182190,16691,31380936,5801254,
12/07/2021,Uttar Pradesh,37697118,514928,31757700,5939418,
13/07/2021,Uttar Pradesh,38345389,648271,32262219,6083170,
14/07/2021,Uttar Pradesh,38837428,492039,32665993,6171435,
15/07/2021,Uttar Pradesh,39516462,679034,33208981,6307481,
16/07/2021,Uttar Pradesh,39934673,418211,33522527,6412146,
17/07/2021,Uttar Pradesh,40351449,416776,33830125,6521324,
18/07/2021,Uttar Pradesh,40368178,16729,33842280,6525898,
19/07/2021,Uttar Pradesh,41047998,679820,34390799,6657199,
20/07/2021,Uttar Pradesh,41559223,511225,34794693,6764530,
21/07/2021,Uttar Pradesh,42034554,475331,35196571,6837983,
22/07/2021,Uttar Pradesh,42792380,757826,35830969,6961411,
23/07/2021,Uttar Pradesh,43807386,1015006,36704592,7102794,
24/07/2021,Uttar Pradesh,44388727,581341,37179632,7209095,
25/07/2021,Uttar Pradesh,44412722,23995,37199136,7213586,
26/07/2021,Uttar Pradesh,45228929,816207,37893326,7335603,
27/07/2021,Uttar Pradesh,45716508,487579,38286687,7429821,
28/07/2021,Uttar Pradesh,46335570,619062,38818090,7517480,
29/07/2021,Uttar Pradesh,46779743,444173,39184333,7595410,
30/07/2021,Uttar Pradesh,47597459,817716,39901008,7696451,
31/07/2021,Uttar Pradesh,48276029,678570,40485878,7790151,
01/08/2021,Uttar Pradesh,48442455,166426,40646488,7795967,
02/08/2021,Uttar Pradesh,48820310,377855,40954861,7865449,
03/08/2021,Uttar Pradesh,51489309,2668999,43425457,8063852,
04/08/2021,Uttar Pradesh,52140923,651614,43999474,8141449,
05/08/2021,Uttar Pradesh,52838552,697629,44597018,8241534,
06/08/2021,Uttar Pradesh,53294582,456030,44973804,8320778,
07/08/2021,Uttar Pradesh,53589814,295232,45198365,8391449,
08/08/2021,Uttar Pradesh,53608615,18801,45211718,8396897,
09/08/2021,Uttar Pradesh,54447724,839109,45932488,8515236,
,,,,,,
,,,,,,
,,,,,,
,,,,,,
,,,,,,
,,,,,,
16/01/2021,Uttarakhand,511,511,511,0,511
17/01/2021,Uttarakhand,556,45,556,0,556
18/01/2021,Uttarakhand,517,-39,517,0,517
19/01/2021,Uttarakhand,1141,624,1141,0,1141
20/01/2021,Uttarakhand,1141,0,1141,0,1141
21/01/2021,Uttarakhand,1874,733,1874,0,1874
22/01/2021,Uttarakhand,3163,1289,3163,0,3163
23/01/2021,Uttarakhand,3238,75,3238,0,3238
24/01/2021,Uttarakhand,3592,354,3592,0,3592
25/01/2021,Uttarakhand,7969,4377,7969,0,7969
26/01/2021,Uttarakhand,8052,83,8052,0,8052
27/01/2021,Uttarakhand,9374,1322,9374,0,9374
28/01/2021,Uttarakhand,14440,5066,14440,0,14440
29/01/2021,Uttarakhand,20864,6424,20864,0,20864
30/01/2021,Uttarakhand,23922,3058,23922,0,23922
31/01/2021,Uttarakhand,26517,2595,26517,0,26517
01/02/2021,Uttarakhand,32705,6188,32705,0,32705
02/02/2021,Uttarakhand,39523,6818,39523,0,39523
03/02/2021,Uttarakhand,50614,11091,50614,0,50614
04/02/2021,Uttarakhand,59962,9348,59962,0,59962
05/02/2021,Uttarakhand,66129,6167,66129,0,66129
06/02/2021,Uttarakhand,70338,4209,70338,0,70338
07/02/2021,Uttarakhand,71384,1046,71384,0,71384
08/02/2021,Uttarakhand,76758,5374,76758,0,76758
09/02/2021,Uttarakhand,83729,6971,83729,0,83729
10/02/2021,Uttarakhand,89655,5926,89655,0,89655
11/02/2021,Uttarakhand,97287,7632,97287,0,97287
12/02/2021,Uttarakhand,104337,7050,104337,0,104337
13/02/2021,Uttarakhand,110369,6032,109966,403,109966
14/02/2021,Uttarakhand,111986,1617,111576,410,111576
15/02/2021,Uttarakhand,119761,7775,118110,1651,118110
16/02/2021,Uttarakhand,126204,6443,123162,3042,123162
17/02/2021,Uttarakhand,131225,5021,127874,3351,127874
18/02/2021,Uttarakhand,135708,4483,130669,5039,130669
19/02/2021,Uttarakhand,143945,8237,136557,7388,136557
20/02/2021,Uttarakhand,146541,2596,138252,8289,138252
21/02/2021,Uttarakhand,146976,435,138670,8306,138670
22/02/2021,Uttarakhand,151842,4866,140932,10910,140932
23/02/2021,Uttarakhand,155814,3972,143357,12457,143357
24/02/2021,Uttarakhand,157621,1807,144911,12710,144911
25/02/2021,Uttarakhand,161766,4145,146325,15441,146325
26/02/2021,Uttarakhand,168602,6836,148098,20504,148098
27/02/2021,Uttarakhand,168602,0,148098,20504,148098
28/02/2021,Uttarakhand,168604,2,148100,20504,148100
01/03/2021,Uttarakhand,168604,0,148100,20504,148100
02/03/2021,Uttarakhand,183073,14469,156016,27057,156016
03/03/2021,Uttarakhand,194732,11659,161695,33037,161695
04/03/2021,Uttarakhand,214010,19278,170995,43015,170995
05/03/2021,Uttarakhand,231192,17182,180506,50686,180506
06/03/2021,Uttarakhand,246725,15533,190962,55763,190962
07/03/2021,Uttarakhand,247447,722,191538,55909,191538
08/03/2021,Uttarakhand,265744,18297,204252,61492,204252
09/03/2021,Uttarakhand,228383,-37361,161046,67337,228383
10/03/2021,Uttarakhand,240790,12407,169248,71542,240790
11/03/2021,Uttarakhand,242965,2175,170797,72168,242965
12/03/2021,Uttarakhand,268380,25415,188021,80359,268380
13/03/2021,Uttarakhand,284179,15799,198622,85557,284179
14/03/2021,Uttarakhand,286192,2013,199855,86337,286192
15/03/2021,Uttarakhand,312088,25896,219454,92634,312088
16/03/2021,Uttarakhand,398546,86458,300292,98254,300292
17/03/2021,Uttarakhand,459272,60726,357365,101907,357365
18/03/2021,Uttarakhand,491749,32477,385031,106718,385031
19/03/2021,Uttarakhand,523715,31966,413175,110540,413175
20/03/2021,Uttarakhand,542470,18755,429295,113175,429295
21/03/2021,Uttarakhand,545854,3384,432481,113373,432481
22/03/2021,Uttarakhand,575163,29309,458968,116195,458968
23/03/2021,Uttarakhand,604131,28968,485452,118679,485452
24/03/2021,Uttarakhand,623127,18996,502979,120148,502979
25/03/2021,Uttarakhand,651083,27956,529381,121702,529381
26/03/2021,Uttarakhand,677407,26324,554351,123056,554351
27/03/2021,Uttarakhand,691740,14333,567912,123828,567912
28/03/2021,Uttarakhand,692153,413,568301,123852,568301
29/03/2021,Uttarakhand,692153,0,568301,123852,568301
30/03/2021,Uttarakhand,709629,17476,583674,125955,583674
31/03/2021,Uttarakhand,729248,19619,600464,128784,600464
01/04/2021,Uttarakhand,766976,37728,635483,131493,635483
02/04/2021,Uttarakhand,819787,52811,684342,135445,684342
03/04/2021,Uttarakhand,864109,44322,724528,139581,724528
04/04/2021,Uttarakhand,911431,47322,768440,142991,768440
05/04/2021,Uttarakhand,963846,52415,816359,147487,816359
06/04/2021,Uttarakhand,1010592,46746,859144,151448,859144
07/04/2021,Uttarakhand,1103202,92610,943113,160089,943113
08/04/2021,Uttarakhand,1183048,79846,1015354,167694,1015354
09/04/2021,Uttarakhand,1243903,60855,1070092,173811,1070092
10/04/2021,Uttarakhand,1284053,40150,1105047,179006,1105047
11/04/2021,Uttarakhand,1309345,25292,1127677,181668,1127677
12/04/2021,Uttarakhand,1362476,53131,1171473,191003,1171473
13/04/2021,Uttarakhand,1403514,41038,1205463,198051,1205463
14/04/2021,Uttarakhand,1432533,29019,1228701,203832,1228701
15/04/2021,Uttarakhand,1467119,34586,1254070,213049,1254070
16/04/2021,Uttarakhand,1519229,52110,1291512,227717,1291512
17/04/2021,Uttarakhand,1565895,46666,1324893,241002,1324893
18/04/2021,Uttarakhand,1568659,2764,1326852,241807,1326852
19/04/2021,Uttarakhand,1628596,59937,1367015,261581,1367015
20/04/2021,Uttarakhand,1679001,50405,1400819,278182,1400819
21/04/2021,Uttarakhand,1716299,37298,1426757,289542,1426757
22/04/2021,Uttarakhand,1767643,51344,1461317,306326,1461317
23/04/2021,Uttarakhand,1810870,43227,1491294,319576,1491294
24/04/2021,Uttarakhand,1851547,40677,1519001,332546,1519001
25/04/2021,Uttarakhand,1868785,17238,1531495,337290,1531495
26/04/2021,Uttarakhand,1919534,50749,1564510,355024,1564510
27/04/2021,Uttarakhand,1953190,33656,1587147,366043,1587147
28/04/2021,Uttarakhand,1992077,38887,1612469,379608,1612469
29/04/2021,Uttarakhand,2036059,43982,1639998,396061,1639998
30/04/2021,Uttarakhand,2079214,43155,1665065,414149,1665065
01/05/2021,Uttarakhand,2099055,19841,1674974,424081,1674974
02/05/2021,Uttarakhand,2105869,6814,1677900,427969,1677900
03/05/2021,Uttarakhand,2117345,11476,1683130,434215,1683130
04/05/2021,Uttarakhand,2149462,32117,1695482,453980,1695482
05/05/2021,Uttarakhand,2197687,48225,1712874,484813,1712874
06/05/2021,Uttarakhand,2256480,58793,1734466,522014,1734466
07/05/2021,Uttarakhand,2307663,51183,1753256,554407,1753256
08/05/2021,Uttarakhand,2349729,42066,1768741,580988,1768741
09/05/2021,Uttarakhand,2373371,23642,1777937,595434,1777937
10/05/2021,Uttarakhand,2445484,72113,1813356,632128,1813356
11/05/2021,Uttarakhand,2511832,66348,1850845,660987,1850845
12/05/2021,Uttarakhand,2546600,34768,1880013,666587,1880013
13/05/2021,Uttarakhand,2578678,32078,1907366,671312,1907366
14/05/2021,Uttarakhand,2613490,34812,1937336,676154,1937336
15/05/2021,Uttarakhand,2645339,31849,1964930,680409,1964930
16/05/2021,Uttarakhand,2663086,17747,1982530,680556,1982530
17/05/2021,Uttarakhand,2691931,28845,2011224,680707,2011224
18/05/2021,Uttarakhand,2715141,23210,2034375,680766,2034375
19/05/2021,Uttarakhand,2727448,12307,2046650,680798,2046650
20/05/2021,Uttarakhand,2744103,16655,2063198,680905,2063198
21/05/2021,Uttarakhand,2759084,14981,2078139,680945,2078139
22/05/2021,Uttarakhand,2772880,13796,2091853,681027,2091853
23/05/2021,Uttarakhand,2783836,10956,2102721,681115,2102721
24/05/2021,Uttarakhand,2807770,23934,2126366,681404,2126366
25/05/2021,Uttarakhand,2829587,21817,2147806,681781,2147806
26/05/2021,Uttarakhand,2838290,8703,2156373,681917,2156373
27/05/2021,Uttarakhand,2857400,19110,2175239,682161,2175239
28/05/2021,Uttarakhand,2875266,17866,2192644,682622,2192644
29/05/2021,Uttarakhand,2891355,16089,2208274,683081,2208274
30/05/2021,Uttarakhand,2901614,10259,2218328,683286,2218328
31/05/2021,Uttarakhand,2919103,17489,2235181,683922,2235181
01/06/2021,Uttarakhand,2932620,13517,2248175,684445,2248175
02/06/2021,Uttarakhand,2944942,12322,2259962,684980,2259962
03/06/2021,Uttarakhand,2962710,17768,2277114,685596,2277114
04/06/2021,Uttarakhand,2988289,25579,2301935,686354,2301935
05/06/2021,Uttarakhand,3025671,37382,2338708,686963,2338708
06/06/2021,Uttarakhand,3050222,24551,2362816,687406,2362816
07/06/2021,Uttarakhand,3084855,34633,2396288,688567,2396288
08/06/2021,Uttarakhand,3118649,33794,2429187,689462,2429187
09/06/2021,Uttarakhand,3156637,37988,2466183,690454,2466183
10/06/2021,Uttarakhand,3207393,50756,2515957,691436,2515957
11/06/2021,Uttarakhand,3250658,43265,2558034,692624,2558034
12/06/2021,Uttarakhand,3285612,34954,2590812,694800,2590812
13/06/2021,Uttarakhand,3320539,34927,2622029,698510,2622029
14/06/2021,Uttarakhand,3377012,56473,2671224,705788,2671224
15/06/2021,Uttarakhand,3419105,42093,2705277,713828,2705277
16/06/2021,Uttarakhand,3444654,25549,2725505,719149,2725505
17/06/2021,Uttarakhand,3477183,32529,2752271,724912,2752271
18/06/2021,Uttarakhand,3515649,38466,2786799,728850,2786799
19/06/2021,Uttarakhand,3541936,26287,2809750,732186,2809750
20/06/2021,Uttarakhand,3556154,14218,2821983,734171,2821983
21/06/2021,Uttarakhand,3676500,120346,2938547,737953,2938547
22/06/2021,Uttarakhand,3799085,122585,3056963,742122,3056963
23/06/2021,Uttarakhand,3922340,123255,3176320,746020,3176320
24/06/2021,Uttarakhand,4026451,104111,3274993,751458,3274993
25/06/2021,Uttarakhand,4124177,97726,3365897,758280,
26/06/2021,Uttarakhand,4193872,69695,3425878,767994,
27/06/2021,Uttarakhand,4214564,20692,3443111,771453,
28/06/2021,Uttarakhand,4262996,48432,3478499,784497,
29/06/2021,Uttarakhand,4339656,76660,3536398,803258,
30/06/2021,Uttarakhand,4401789,62133,3579832,821957,
01/07/2021,Uttarakhand,4446547,44758,3609832,836715,
02/07/2021,Uttarakhand,4479447,32900,3631790,847657,
03/07/2021,Uttarakhand,4527294,47847,3664283,863011,
04/07/2021,Uttarakhand,4588910,61616,3710330,878580,
05/07/2021,Uttarakhand,4687985,99075,3774218,913767,
06/07/2021,Uttarakhand,4762569,74584,3821058,941511,
07/07/2021,Uttarakhand,4801508,38939,3843884,957624,
08/07/2021,Uttarakhand,4836289,34781,3865405,970884,
09/07/2021,Uttarakhand,4864248,27959,3882032,982216,
10/07/2021,Uttarakhand,4889320,25072,3899297,990023,
11/07/2021,Uttarakhand,4907160,17840,3913957,993203,
12/07/2021,Uttarakhand,4931083,23923,3930208,1000875,
13/07/2021,Uttarakhand,4960171,29088,3938366,1021805,
14/07/2021,Uttarakhand,5024419,64248,3968209,1056210,
15/07/2021,Uttarakhand,5092396,67977,3992311,1100085,
16/07/2021,Uttarakhand,5145220,52824,4014316,1130904,
17/07/2021,Uttarakhand,5201427,56207,4035902,1165525,
18/07/2021,Uttarakhand,5230315,28888,4052712,1177603,
19/07/2021,Uttarakhand,5298863,68548,4088662,1210201,
20/07/2021,Uttarakhand,5373777,74914,4132892,1240885,
21/07/2021,Uttarakhand,5405942,32165,4150600,1255342,
22/07/2021,Uttarakhand,5448544,42602,4169098,1279446,
23/07/2021,Uttarakhand,5498462,49918,4195409,1303053,
24/07/2021,Uttarakhand,5526721,28259,4210352,1316369,
25/07/2021,Uttarakhand,5537425,10704,4213887,1323538,
26/07/2021,Uttarakhand,5573723,36298,4229473,1344250,
27/07/2021,Uttarakhand,5615998,42275,4248420,1367578,
28/07/2021,Uttarakhand,5648690,32692,4268486,1380204,
29/07/2021,Uttarakhand,5742959,94269,4346421,1396538,
30/07/2021,Uttarakhand,5831817,88858,4413409,1418408,
31/07/2021,Uttarakhand,5906990,75173,4470779,1436211,
01/08/2021,Uttarakhand,6002377,95387,4557653,1444724,
02/08/2021,Uttarakhand,6089182,86805,4625366,1463816,
03/08/2021,Uttarakhand,6165004,75822,4682015,1482989,
04/08/2021,Uttarakhand,6272010,107006,4768578,1503432,
05/08/2021,Uttarakhand,6369471,97461,4842044,1527427,
06/08/2021,Uttarakhand,6424278,54807,4882166,1542112,
07/08/2021,Uttarakhand,6598224,173946,5023301,1574923,
08/08/2021,Uttarakhand,6625373,27149,5041919,1583454,
09/08/2021,Uttarakhand,6667116,41743,5070544,1596572,
,,,,,,
,,,,,,
,,,,,,
,,,,,,
,,,,,,
,,,,,,
16/01/2021,West Bengal,1917,1917,1917,0,1917
17/01/2021,West Bengal,2085,168,2085,0,2085
18/01/2021,West Bengal,5060,2975,5060,0,5060
19/01/2021,West Bengal,12364,7304,12364,0,12364
20/01/2021,West Bengal,14624,2260,14624,0,14624
21/01/2021,West Bengal,20206,5582,20206,0,20206
22/01/2021,West Bengal,41970,21764,41970,0,41970
23/01/2021,West Bengal,43180,1210,43180,0,43180
24/01/2021,West Bengal,46143,2963,46143,0,46143
25/01/2021,West Bengal,87815,41672,87815,0,87815
26/01/2021,West Bengal,88627,812,88627,0,88627
27/01/2021,West Bengal,130937,42310,130937,0,130937
28/01/2021,West Bengal,161415,30478,161415,0,161415
29/01/2021,West Bengal,191566,30151,191566,0,191566
30/01/2021,West Bengal,214018,22452,214018,0,214018
31/01/2021,West Bengal,214256,238,214256,0,214256
01/02/2021,West Bengal,238178,23922,238178,0,238178
02/02/2021,West Bengal,259341,21163,259341,0,259341
03/02/2021,West Bengal,271828,12487,271828,0,271828
04/02/2021,West Bengal,290908,19080,290908,0,290908
05/02/2021,West Bengal,314065,23157,314065,0,314065
06/02/2021,West Bengal,323825,9760,323825,0,323825
07/02/2021,West Bengal,323859,34,323859,0,323859
08/02/2021,West Bengal,346113,22254,346113,0,346113
09/02/2021,West Bengal,372621,26508,372621,0,372621
10/02/2021,West Bengal,396442,23821,396442,0,396442
11/02/2021,West Bengal,421678,25236,421678,0,421678
12/02/2021,West Bengal,451987,30309,451987,0,451987
13/02/2021,West Bengal,481827,29840,480743,1084,480743
14/02/2021,West Bengal,485365,3538,484229,1136,484229
15/02/2021,West Bengal,525918,40553,519678,6240,519678
16/02/2021,West Bengal,528075,2157,521537,6538,521537
17/02/2021,West Bengal,551037,22962,538752,12285,538752
18/02/2021,West Bengal,563290,12253,544667,18623,544667
19/02/2021,West Bengal,632088,68798,596408,35680,596408
20/02/2021,West Bengal,664855,32767,620329,44526,620329
21/02/2021,West Bengal,669761,4906,625050,44711,625050
22/02/2021,West Bengal,726880,57119,662851,64029,662851
23/02/2021,West Bengal,788276,61396,712116,76160,712116
24/02/2021,West Bengal,873017,84741,778861,94156,778861
25/02/2021,West Bengal,978851,105834,864083,114768,864083
26/02/2021,West Bengal,1092729,113878,953882,138847,953882
27/02/2021,West Bengal,1092729,0,953882,138847,953882
28/02/2021,West Bengal,1092729,0,953882,138847,953882
01/03/2021,West Bengal,1092729,0,953882,138847,953882
02/03/2021,West Bengal,1170037,77308,1012276,157761,1012276
03/03/2021,West Bengal,1261351,91314,1081891,179460,1081891
04/03/2021,West Bengal,1352180,90829,1151159,201021,1151159
05/03/2021,West Bengal,1448516,96336,1226222,222294,1226222
06/03/2021,West Bengal,1537566,89050,1299938,237628,1299938
07/03/2021,West Bengal,1547453,9887,1308982,238471,1308982
08/03/2021,West Bengal,1684182,136729,1424182,260000,1424182
09/03/2021,West Bengal,1596681,-87501,1312737,283944,1596681
10/03/2021,West Bengal,1730915,134234,1426418,304497,1730915
11/03/2021,West Bengal,1801974,71059,1486241,315733,1801974
12/03/2021,West Bengal,1983003,181029,1641083,341920,1983003
13/03/2021,West Bengal,2104249,121246,1742140,362109,2104249
14/03/2021,West Bengal,2117985,13736,1753914,364071,2117985
15/03/2021,West Bengal,2353011,235026,1958513,394498,2353011
16/03/2021,West Bengal,2818171,465160,2400215,417956,2400215
17/03/2021,West Bengal,3121794,303623,2688119,433675,2688119
18/03/2021,West Bengal,3260568,138774,2808898,451670,2808898
19/03/2021,West Bengal,3561127,300559,3086159,474968,3086159
20/03/2021,West Bengal,3758013,196886,3263416,494597,3263416
21/03/2021,West Bengal,3791481,33468,3294084,497397,3294084
22/03/2021,West Bengal,4029095,237614,3505433,523662,3505433
23/03/2021,West Bengal,4284851,255756,3727569,557282,3727569
24/03/2021,West Bengal,4428925,144074,3850626,578299,3850626
25/03/2021,West Bengal,4577280,148355,3976580,600700,3976580
26/03/2021,West Bengal,4883468,306188,4261110,622358,4261110
27/03/2021,West Bengal,5082386,198918,4448531,633855,4448531
28/03/2021,West Bengal,5087735,5349,4453685,634050,4453685
29/03/2021,West Bengal,5110946,23211,4475456,635490,4475456
30/03/2021,West Bengal,5323718,212772,4671332,652386,4671332
31/03/2021,West Bengal,5467439,143721,4798424,669015,4798424
01/04/2021,West Bengal,5614451,147012,4932709,681742,4932709
02/04/2021,West Bengal,5796984,182533,5103078,693906,5103078
03/04/2021,West Bengal,5967900,170916,5260046,707854,5260046
04/04/2021,West Bengal,6148158,180258,5427490,720668,5427490
05/04/2021,West Bengal,6396475,248317,5657151,739324,5657151
06/04/2021,West Bengal,6639763,243288,5881580,758183,5881580
07/04/2021,West Bengal,7020613,380850,6222811,797802,6222811
08/04/2021,West Bengal,7311686,291073,6465014,846672,6465014
09/04/2021,West Bengal,7673269,361583,6783892,889377,6783892
10/04/2021,West Bengal,7891168,217899,6972586,918582,6972586
11/04/2021,West Bengal,7982276,91108,7051017,931259,7051017
12/04/2021,West Bengal,8224788,242512,7241680,983108,7241680
13/04/2021,West Bengal,8345059,120271,7328009,1017050,7328009
14/04/2021,West Bengal,8442892,97833,7398413,1044479,7398413
15/04/2021,West Bengal,8468805,25913,7415379,1053426,7415379
16/04/2021,West Bengal,8608782,139977,7499090,1109692,7499090
17/04/2021,West Bengal,8739716,130934,7577053,1162663,7577053
18/04/2021,West Bengal,8764150,24434,7593056,1171094,7593056
19/04/2021,West Bengal,8976141,211991,7701111,1275030,7701111
20/04/2021,West Bengal,9209694,233553,7830594,1379100,7830594
21/04/2021,West Bengal,9396068,186374,7934464,1461604,7934464
22/04/2021,West Bengal,9558233,162165,8024582,1533651,8024582
23/04/2021,West Bengal,9780255,222022,8139244,1641011,8139244
24/04/2021,West Bengal,9938423,158168,8227116,1711307,8227116
25/04/2021,West Bengal,9969252,30829,8243729,1725523,8243729
26/04/2021,West Bengal,10228994,259742,8363314,1865680,8363314
27/04/2021,West Bengal,10437665,208671,8467133,1970532,8467133
28/04/2021,West Bengal,10630769,193104,8539976,2090793,8539976
29/04/2021,West Bengal,10781641,150872,8596240,2185401,8596240
30/04/2021,West Bengal,10971948,190307,8662227,2309721,8662227
01/05/2021,West Bengal,11058053,86105,8689947,2368106,8689947
02/05/2021,West Bengal,11066324,8271,8692844,2373480,8692844
03/05/2021,West Bengal,11256097,189773,8725020,2531077,8725020
04/05/2021,West Bengal,11409897,153800,8750404,2659493,8750404
05/05/2021,West Bengal,11506727,96830,8764695,2742032,8764695
06/05/2021,West Bengal,11594723,87996,8777268,2817455,8777268
07/05/2021,West Bengal,11839680,244957,8808010,3031670,8808010
08/05/2021,West Bengal,11952404,112724,8823763,3128641,8823763
09/05/2021,West Bengal,11963861,11457,8825922,3137939,8825922
10/05/2021,West Bengal,12108661,144800,8844778,3263883,8844778
11/05/2021,West Bengal,12226878,118217,8862487,3364391,8862487
12/05/2021,West Bengal,12408070,181192,8890679,3517391,8890679
13/05/2021,West Bengal,12562690,154620,8916777,3645913,8916777
14/05/2021,West Bengal,12609247,46557,8929070,3680177,8929070
15/05/2021,West Bengal,12673069,63822,8955081,3717988,8955081
16/05/2021,West Bengal,12678649,5580,8958736,3719913,8958736
17/05/2021,West Bengal,12741310,62661,9001376,3739934,9001376
18/05/2021,West Bengal,12805341,64031,9046876,3758465,9046876
19/05/2021,West Bengal,12869283,63942,9095356,3773927,9095356
20/05/2021,West Bengal,12933777,64494,9145955,3787822,9145955
21/05/2021,West Bengal,13005623,71846,9202262,3803361,9202262
22/05/2021,West Bengal,13088982,83359,9274004,3814978,9274004
23/05/2021,West Bengal,13144472,55490,9329018,3815454,9329018
24/05/2021,West Bengal,13334185,189713,9506802,3827383,9506802
25/05/2021,West Bengal,13492633,158448,9656735,3835898,9656735
26/05/2021,West Bengal,13555378,62745,9718236,3837142,9718236
27/05/2021,West Bengal,13729739,174361,9887152,3842587,9887152
28/05/2021,West Bengal,13993297,263558,10141006,3852291,10141006
29/05/2021,West Bengal,14271067,277770,10407006,3864061,10407006
30/05/2021,West Bengal,14412969,141902,10547015,3865954,10547015
31/05/2021,West Bengal,14718135,305166,10838457,3879678,10838457
01/06/2021,West Bengal,14969157,251022,11075394,3893763,11075394
02/06/2021,West Bengal,15186412,217255,11283299,3903113,11283299
03/06/2021,West Bengal,15430414,244002,11514760,3915654,11514760
04/06/2021,West Bengal,15726490,296076,11795260,3931230,11795260
05/06/2021,West Bengal,16031152,304662,12090072,3941080,12090072
06/06/2021,West Bengal,16149949,118797,12206706,3943243,12206706
07/06/2021,West Bengal,16453879,303930,12492937,3960942,12492937
08/06/2021,West Bengal,16717047,263168,12742698,3974349,12742698
09/06/2021,West Bengal,16940919,223872,12954543,3986376,12954543
10/06/2021,West Bengal,17139018,198099,13143096,3995922,13143096
11/06/2021,West Bengal,17382133,243115,13364800,4017333,13364800
12/06/2021,West Bengal,17600439,218306,13561818,4038621,13561818
13/06/2021,West Bengal,17657700,57261,13615740,4041960,13615740
14/06/2021,West Bengal,17867444,209744,13798076,4069368,13798076
15/06/2021,West Bengal,18123718,256274,14013951,4109767,14013951
16/06/2021,West Bengal,18249050,125332,14127403,4121647,14127403
17/06/2021,West Bengal,18431037,181987,14282047,4148990,14282047
18/06/2021,West Bengal,18645621,214584,14455315,4190306,14455315
19/06/2021,West Bengal,18937419,291798,14677149,4260270,14677149
20/06/2021,West Bengal,19010947,73528,14736671,4274276,14736671
21/06/2021,West Bengal,19349842,338895,14997560,4352282,14997560
22/06/2021,West Bengal,19667535,317693,15251854,4415681,15251854
23/06/2021,West Bengal,20022881,355346,15536230,4486651,15536230
24/06/2021,West Bengal,20352923,330042,15798841,4554082,15798841
25/06/2021,West Bengal,20739972,387049,16098954,4641018,
26/06/2021,West Bengal,21043842,303870,16320306,4723536,
27/06/2021,West Bengal,21128717,84875,16382560,4746157,
28/06/2021,West Bengal,21427071,298354,16563389,4863682,
29/06/2021,West Bengal,21711965,284894,16729378,4982587,
30/06/2021,West Bengal,21889622,177657,16833029,5056593,
01/07/2021,West Bengal,22009840,120218,16900071,5109769,
02/07/2021,West Bengal,22319689,309849,17019095,5300594,
03/07/2021,West Bengal,22591117,271428,17135494,5455623,
04/07/2021,West Bengal,22660276,69159,17165989,5494287,
05/07/2021,West Bengal,22960000,299724,17285927,5674073,
06/07/2021,West Bengal,23205213,245213,17382673,5822540,
07/07/2021,West Bengal,23366652,161439,17454711,5911941,
08/07/2021,West Bengal,23612813,246161,17550438,6062375,
09/07/2021,West Bengal,23853229,240416,17633240,6219989,
10/07/2021,West Bengal,24068021,214792,17705150,6362871,
11/07/2021,West Bengal,24157577,89556,17733441,6424136,
12/07/2021,West Bengal,24356550,198973,17798311,6558239,
13/07/2021,West Bengal,24586285,229735,17895909,6690376,
14/07/2021,West Bengal,25034355,448070,18136147,6898208,
15/07/2021,West Bengal,25273258,238903,18247452,7025806,
16/07/2021,West Bengal,25609415,336157,18379397,7230018,
17/07/2021,West Bengal,26000121,390706,18540516,7459605,
18/07/2021,West Bengal,26098053,97932,18590094,7507959,
19/07/2021,West Bengal,26425090,327037,18750894,7674196,
20/07/2021,West Bengal,26685478,260388,18892232,7793246,
21/07/2021,West Bengal,26778393,92915,18951477,7826916,
22/07/2021,West Bengal,26997115,218722,19069566,7927549,
23/07/2021,West Bengal,27340804,343689,19261651,8079153,
24/07/2021,West Bengal,27681733,340929,19487241,8194492,
25/07/2021,West Bengal,27759330,77597,19549132,8210198,
26/07/2021,West Bengal,28065385,306055,19762581,8302804,
27/07/2021,West Bengal,28332814,267429,19956751,8376063,
28/07/2021,West Bengal,28597528,264714,20136326,8461202,
29/07/2021,West Bengal,28826431,228903,20302042,8524389,
30/07/2021,West Bengal,29150043,323612,20538959,8611084,
31/07/2021,West Bengal,29518698,368655,20837318,8681380,
01/08/2021,West Bengal,29805755,287057,21101118,8704637,
02/08/2021,West Bengal,30244279,438524,21455703,8788576,
03/08/2021,West Bengal,30676340,432061,21816275,8860065,
04/08/2021,West Bengal,30970620,294280,22061792,8908828,
05/08/2021,West Bengal,31371174,400554,22401043,8970131,
06/08/2021,West Bengal,31774086,402912,22745949,9028137,
07/08/2021,West Bengal,32029325,255239,22959053,9070272,
08/08/2021,West Bengal,32098768,69443,23017864,9080904,
09/08/2021,West Bengal,32390378,291610,23257417,9132961,
